AgnipadaH => agnipada + aR
AgrahAyaRaH => agrahAyaRa + aR
AgrAyaRaH => agrAyaRa + aR
ANgAram => aNgAra + aR
AjavAhaH => ajavAha + aR
AnaBimlAnaH => anaBimlAna + aR
AnirudDaH => anirudDa + aR
AnucArakaH => anucAraka + aR
AnujAvaraH => anujAvara + aR
AnuvArakaH => anuvAraka + aR
AnuzaRqaH => anuzaRqa + aR
AnuzUkaH => anuzUka + aR
AnUpaH => anUpa + aR
AnfSaMsam => anfSaMsa + aR
ABijitaH => aBijita + aR
AmitraH => amitra + aR
AyasTURaH => ayasTURa + aR
AruRaH => aruRa + aR
AryaSvetaH => aryaSveta + aR
ASvaH => aSva + aR
ASvatTam => aSvatTa + aR
AsuraH => asura + aR
AsyahAtyaH => asyahatya + aR
AhisakTaH => ahisakTa + aR
AryaSvetaH => AryaSveta + aR
AleKanaH => AleKana + aR
EndrAdfSaH => indrAdfSa + aR
EndrAyuDaH => indrAyuDa + aR
EndrAliSaH => indrAliSa + aR
OtkzepaH => utkzepa + aR
OttarABAdrapadaH => uttarABAdrapada + aR
OtpAdaH => utpAda + aR
OtsaH => utsa + aR
OdapAnaH => udapAna + aR
OdumbaraH => udumbara + aR
OdyAvaH => udyAva + aR
OpalaH => upala + aR
OpavAsaH => upavAsa + aR
OpasaMkramaRaH => upasaMkramaRa + aR
OpasaNkramaRaH => upasaNkramaRa + aR
OpasadaH => upasada + aR
ArzwizeRaH => fzwizeRa + aR
kAkutsTaH => kakutsTa + aR
kAcCaH => kacCa + aR
kAwukam => kawuka + aR
kApiYjalaH => kapiYjala + aR
kApilaH => kapila + aR
kApiSaH => kapiSa + aR
kApotaH => kapota + aR
kAmalakIkaraH => kamalakIkara + aR
kAmalakIwaH => kamalakIwa + aR
kAmbojaH => kamboja + aR
kArIraH => karIra + aR
kArIzam => karIza + aR
kArkaH => karka + aR
kArkaSaH => karkaSa + aR
kArRaH => karRa + aR
kArparaH => karpara + aR
kArmAraH => karmAra + aR
kAlakIwaH => kalakIwa + aR
kAlaSaH => kalaSa + aR
kAliNgaH => kaliNga + aR
kAlUtaraH => kalUtara + aR
kAlpasUtraH => kalpasUtra + aR
kASmIraH => kaSmIra + aR
kAzAyaH => kazAya + aR
kAhayaH => kahaya + aR
kAhUyaH => kahUya + aR
kAhoqaH => kahoqa + aR
kAkaH => kAka + aR
kARqaH => kARqa + aR
kARvaH => kARvya + aR
kApotaH => kApota + aR
kArzApaRaH => kArzApaRa + aR
kAlaH => kAla + aR
kOwIraH => kuwIra + aR
kOWAraH => kuWAra + aR
kORapaH => kuRapa + aR
kORqalaH => kuRqala + aR
kOtapaH => kutapa + aR
kOtukam => kutuka + aR
kOtUhalam => kutUhala + aR
kOpiYjalaH => kupiYjala + aR
kOmBaH => kumBa + aR
kOlAlaH => kulAla + aR
kOSalam => kuSala + aR
kOsumBaH => kusumBa + aR
kArkaRaH => kfkaRa + aR
kArpaRaH => kfpaRa + aR
kArzRakarRaH => kfzRakarRa + aR
kOhaqaH => kohaqa + aR
kOhitaH => kohita + aR
krOYcaH => kruYca + aR
kzErahradaH => kzIrahrada + aR
kzEtram => kzetra + aR
kzEtrajYam => kzetrajYa + aR
KAYjanaH => KaYjana + aR
KAYjAraH => KaYjAra + aR
KAYjAlaH => KaYjAla + aR
KAdiraH => Kadira + aR
KAdUrakaH => KadUraka + aR
KArjUrakarRaH => KarjUrakarRa + aR
gAnDAraH => ganDAra + aR
gArtaH => garta + aR
gArgaH => gArgya + aR
gODUmaH => goDUma + aR
gOpucCaH => gopucCa + aR
gOhyaH => gohya + aR
grEvAkzaH => grIvAkza + aR
grEzmaH => grIzma + aR
GArtaH => Gfta + aR
cARqaH => caRqa + aR
cARqAlaH => caRqAla + aR
cAturdaSaH => caturdaSa + aR
cAturhAyaRam => caturhAyaRa + aR
cAtuzprASyaH => catuzprASya + aR
cApalam => capala + aR
cAyaH => caya + aR
CAgalaH => Cagala + aR
CAndomAnaH => CandomAna + aR
jAmBaH => jamBa + aR
jAlahradaH => jalahrada + aR
jAlakIwaH => jAlakIwa + aR
JArJaraH => JarJara + aR
tAmisraH => tamisra + aR
tAlaH => tAla + aR
tEttiqIkaH => tittiqIka + aR
tEttiraH => tittira + aR
tEzaH => tizya + aR
tErTaH => tIrTa + aR
tArkzAkaH => tfkzAka + aR
tArRaH => tfRa + aR
tArRakarRaH => tfRakarRa + aR
trESARaH => triSARa + aR
trEhAyaRam => trihAyaRa + aR
trEhAyaRam => trihAyana + aR
dARqaH => daRqa + aR
dAttaH => datta + aR
dAradaH => darada + aR
dASArRaH => daSArRa + aR
dASArhaH => daSArha + aR
dOrhfdayam => durhfdaya + aR
dEvAsuraH => devAsura + aR
drOhyaH => druhya + aR
dvESARaH => dviSARa + aR
dvEhAyanam => dvihAyana + aR
dvEpaH => dvIpa + aR
DAvalaH => Davala + aR
DOrtaH => DUrta + aR
DOsaraH => DUsara + aR
nAkulaH => nakula + aR
nABAkaH => naBAka + aR
nAraH => nara + aR
nAraNgaH => nAraNga + aR
nEgamaH => nigama + aR
nEtyaH => nitya + aR
nEpuRam => nipuRa + aR
nEmittaH => nimitta + aR
nEzAdaH => nizAda + aR
nEzkramaRaH => nizkramaRa + aR
nyAgroDamUlaH => nyagroDamUla + aR
nEyAyaH => nyAya + aR
pAYcahAyanam => paYcahAyana + aR
pAwaccaraH => pawaccara + aR
pATakaH => paTaka + aR
pAdavyAKyAnaH => padavyAKyAna + aR
pArilaH => parila + aR
pArivrAjakam => parivrAjaka + aR
pArisArakaH => parisAraka + aR
pArRaH => parRa + aR
pArvataH => parvata + aR
pAlASaH => palASa + aR
pAwalaH => pAwala + aR
pEwakaH => piwaka + aR
pEwAkaH => piwAka + aR
pESAcaH => piSAca + aR
pESunam => piSuna + aR
pEzwaH => pizwa + aR
pElumUlaH => pIlumUla + aR
pORqarIkaH => puRqarIka + aR
pOtraH => putra + aR
pOnaruktaH => punarukta + aR
pOruzaH => puruza + aR
pOrohitaH => purohita + aR
pOzyaH => puzya + aR
pOrvABAdrapadaH => pUrvABAdrapada + aR
prAjYaH => prajYa + aR
prAtyakzaH => pratyakza + aR
prAvAsaH => pravAsa + aR
prAveSanaH => praveSana + aR
prOzWaH => prozWa + aR
prOzWikaH => prozWika + aR
plAkzam => plakza + aR
bAkaH => baka + aR
bArhiRaH => bArhiRa + aR
bAhukIwaH => bAhukIwa + aR
bAhlIkaH => bAhlIka + aR
bElvaH => bilva + aR
BAlandaH => Balanda + aR
BAlandanaH => Balandana + aR
BOtam => BUta + aR
BrAzwraH => BrAzwra + aR
mAjirakaH => majiraka + aR
mAYjIrakaH => maYjIraka + aR
mAqqukaH => maqquka + aR
mARqUkaH => maRqUka + aR
mADUkaH => maDUka + aR
mADyaH => maDya + aR
mAyUraH => mayUra + aR
mAyUrakarRaH => mayUrakarRa + aR
mAsurakarRaH => masurakarRa + aR
mAsUraH => masUra + aR
mAhIyatvaH => mahIyatva + aR
mAhendraH => mahendra + aR
mEtraH => mitra + aR
mOdgaH => mudga + aR
mOhUrtaH => muhUrta + aR
yAkfllomaH => yakflloma + aR
yAjamAnaH => yajamAna + aR
yAvAsaH => yavAsa + aR
yAskaH => yaska + aR
yODaH => yoDa + aR
rAktaH => rakta + aR
rAkzosuraH => rakzosura + aR
rAvaRaH => ravaRa + aR
rEKaH => reKa + aR
rODaH => roDa + aR
rOmakaH => romaka + aR
lAvaNgaH => lavaNga + aR
lAhyaH => lahya + aR
lEKaH => leKa + aR
lOhitaH => lohita + aR
vAtaRqaH => vataRqa + aR
vArtanAkzaH => vartanAkza + aR
vASizWaH => vaSizWa + aR
vAsanaH => vasana + aR
vAsizWaH => vasizWa + aR
vAsudevaH => vasudeva + aR
vAstraH => vastra + aR
vAtsaH => vAtsya + aR
vAhIkaH => vAhIka + aR
vEMSatikaH => viMSatika + aR
vEkarRaH => vikarRa + aR
vEjApakaH => vijApaka + aR
vEwakaH => viwaka + aR
vEtaraRaH => vitaraRa + aR
vEpASaH => vipASa + aR
vEmuktaH => vimukta + aR
vEyAtaH => viyAta + aR
vErUpAkzaH => virUpAkza + aR
vESAlaH => viSAla + aR
vESravaRaH => viSravaRa + aR
vESvAmitraH => viSvAmitra + aR
vEzayam => vizaya + aR
vEsarpaH => visarpa + aR
vOpAdikaH => vupAdika + aR
vArzalam => vfzala + aR
vArzRikaH => vfzRika + aR
vESantaH => veSanta + aR
vyAkftaH => vyAkfta + aR
vyOzwaH => vyuzwa + aR
SAkawaH => Sakawa + aR
SAwIkarRaH => SawIkarRa + aR
SAtapatraH => Satapatra + aR
SAtamAnaH => SatamAna + aR
SArAvaH => SarAva + aR
SErIzaH => SirIza + aR
SEvaH => Siva + aR
SESiraH => SiSira + aR
SOklaH => Sukla + aR
SONgaH => SuNga + aR
SORqikaH => SuRqika + aR
SOrasenaH => SUrasena + aR
SORaH => SoRa + aR
SyAmAkaH => SyAmAka + aR
SyAvaH => SyAva + aR
SrAmaRam => SramaRa + aR
SrAvaRam => SravaRa + aR
SrOtram => Srotra + aR
SvAPalkaH => SvaPalka + aR
sAMgrAmaH => saMgrAma + aR
sAMGAtaH => saMGAta + aR
sAMvatsaraH => saMvatsara + aR
sAgaraH => sagara + aR
sANgrAmaH => saNgrAma + aR
sANGAtaH => saNGAta + aR
sAntapatnaH => santapatna + aR
sAnnAyam => sannAya + aR
sAhadevaH => sahadeva + aR
sAhasraH => sahasra + aR
sAlvaH => sAlva + aR
sOKaH => suKa + aR
sOpizwaH => supizwa + aR
sOvarRaH => suvarRa + aR
sOhfdayam => suhfdaya + aR
sOramasaH => sUramasa + aR
sTARqilaH => sTaRqila + aR
sTAviram => sTavira + aR
spAndanaH => spandana + aR
hAritaH => harita + aR
hAridrABaH => haridrABa + aR
hAlaH => hala + aR
hAvirDAnaH => havirDAna + aR
hAstaH => hasta + aR
hAstipadaH => hastipada + aR
AnurADaH => anurADA + aR
AnulepikaH => anulepikA + aR
AmAvAsyaH => amAvAsyA + aR
AhimAlaH => ahimAlA + aR
ArdraH => ArdrA + aR
ASlezaH => ASlezA + aR
ElaH => ilA + aR
OttarAzAQaH => uttarAzAQA + aR
OmaH => umA + aR
kAkuBaH => kakuBA + aR
kAnizWikaH => kanizWikA + aR
kApAwikaH => kapAwikA + aR
kApAlikaH => kapAlikA + aR
kApilikaH => kapilikA + aR
kApizWikaH => kapizWikA + aR
kAmalaBidaH => kamalaBidA + aR
kEzkinDaH => kizkinDA + aR
kOwilikaH => kuwilikA + aR
kOlyaH => kulyA + aR
kArtikaH => kfttikA + aR
kzAtravidyaH => kzatravidyA + aR
gANgaH => gaNgA + aR
gAndikaH => gandikA + aR
gAveDukaH => gaveDukA + aR
grEvaH => grIvA + aR
cAturvEdyaH => caturvidyA + aR
cEtraH => citrA + aR
cEntitaH => cintitA + aR
CAndoBAzaH => CandoBAzA + aR
jAwilikaH => jawilikA + aR
jyEzWaH => jyezWA + aR
jyOtsnaH => jyotsnA + aR
trEvidyaH => trividyA + aR
dAkziRam => dakziRA + aR
DAnizWaH => DanizWA + aR
DArmavidyaH => DarmavidyA + aR
nArmadaH => narmadA + aR
pAriKaH => pariKA + aR
pArzikaH => pArzikA + aR
pEyUkzaH => pIyUkzA + aR
pOrohitikaH => purohitikA + aR
pOrvAzAQaH => pUrvAzAQA + aR
pArTaH => pfTA + aR
prAlepikaH => pralepikA + aR
bADirikaH => baDirikA + aR
BAdraH => BadrA + aR
BEkzaH => BikzA + aR
mAllikaH => mallikA + aR
mArgaSiraH => mfgaSirA + aR
yAmunaH => yamunA + aR
rADaH => rADA + aR
vEtastaH => vitastA + aR
vEdyaH => vidyA + aR
vElepikaH => vilepikA + aR
vESAKaH => viSAKA + aR
SAtaBizaH => SataBizA + aR
SArkaraH => SarkarA + aR
SEMSipaH => SiMSipA + aR
SEkzaH => SikzA + aR
SEkzitaH => SikzitA + aR
SONgaH => SuNgA + aR
SrAvaRaH => SravaRA + aR
sAMDivelaH => saMDivelA + aR
sAMDyaH => saMDyA + aR
sAMsargavidyaH => saMsargavidyA + aR
sAMskftaH => saMskftA + aR
sAnDyaH => sanDyA + aR
sEkataH => sikatA + aR
sOrohikaH => surohikA + aR
sOrohitikaH => surohitikA + aR
hEqimbaH => hiqimbA + aR
ASanaH => aSani + aR
kOlapataH => kulapati + aR
gARapataH => gaRapati + aR
gArhapataH => gfhapati + aR
CAndovicitaH => Candoviciti + aR
jYAnapataH => jYAnapati + aR
DAnapataH => Danapati + aR
DAnvapataH => Danvapati + aR
DArmapataH => Darmapati + aR
DAnyapataH => DAnyapati + aR
pANktaH => paNkti + aR
pAdAtam => padAti + aR
pAdDatam => padDati + aR
prAjApataH => prajApati + aR
prARapataH => prARapati + aR
bAnDupataH => banDupati + aR
BOraH => BUri + aR
yAjYapataH => yajYapati + aR
SAtapataH => Satapati + aR
SOcaH => Suci + aR
sAnDaH => sanDi + aR
sABApataH => saBApati + aR
sTAnapataH => sTAnapati + aR
svAtaH => svAti + aR
ASvinaH => aSvinI + aR
ENgudam => iNgudI + aR
OttaraPAlgunaH => uttaraPAlgunI + aR
OrvaSaH => urvaSI + aR
kArNkaDUmataH => karNkaDUmatI + aR
kArpAsaH => karpAsI + aR
kArtikaH => kArtikI + aR
kOstram => kustrI + aR
gArBiRam => garBiRI + aR
gOmataH => gomatI + aR
gOzWaH => gOzWI + aR
cAturdaSaH => caturdaSI + aR
jAgataH => jagatI + aR
jyEzWaH => jyEzWI + aR
trAyodaSaH => trayodaSI + aR
dOHstraH => duHstrI + aR
nArAcaH => narAcI + aR
nEkataH => nEkatI + aR
pAYcadaSaH => paYcadaSI + aR
pAladaH => paladI + aR
pAwalaH => pAwalI + aR
pOrRamasaH => pOrRamasI + aR
prAjAvataH => prajAvatI + aR
PAlgunaH => PAlgunI + aR
BAraRaH => BaraRI + aR
BAdrapadaH => BAdrapadI + aR
mARipAlaH => maRipAlI + aR
mAhitraH => mahitrI + aR
mAhizaH => mahizI + aR
mAGaSIrzaH => mAGaSIrzI + aR
rOhiRaH => rohiRI + aR
vESAKaH => vESAKI + aR
sApatnaH => sapatnI + aR
sArasvataH => sarasvatI + aR
AgnAvizRavaH => agnAvizRu + aR
ADenavaH => aDenu + aR
ArtavaH => ftu + aR
kAkzatavam => kakzatu + aR
kAmaRqalavam => kamaRqalu + aR
kOravaH => kuru + aR
gOravaH => guru + aR
jAratkAravaH => jaratkAru + aR
tArkavaH => tarku + aR
dAnavaH => danu + aR
pArSavaH => parSu + aR
pARqavaH => pARqu + aR
bAnDavaH => banDu + aR
BARqavaH => BaRqu + aR
mAnavaH => manu + aR
yAdavaH => yadu + aR
rANkavaH => raNku + aR
rOravam => ruru + aR
lAGavaH => laGu + aR
vArRavaH => varRu + aR
vAsavaH => vasu + aR
vEzRavaH => vizRu + aR
SAtravaH => Satru + aR
SEgravam => Sigru + aR
SESavaH => SiSu + aR
sOvastavaH => suvastu + aR
sOvAstavaH => suvAstu + aR
jAmbavam => jambU + aR
dOrBrAtram => durBrAtf + aR
prASitraH => prASitf + aR
sOBrAtram => suBrAtf + aR
cEkIrzataH => cikIrzat + aR
pAtnIvataH => patnIvat + aR
bArhavataH => barhavat + aR
mADumataH => maDumat + aR
mArutaH => marut + aR
vAsumataH => vasumat + aR
sAtvataH => satvat + aR
sAdasataH => sadasat + aR
dAradaH => darad + aR
dOrhArdam => durhfd + aR
prAtipadaH => pratipad + aR
gARinaH => gaRin + aR
gOlomanaH => goloman + aR
cAkravarmaRaH => cakravarman + aR
cAkriRaH => cakrin + aR
cArmiRam => carmin + aR
dvAyahanaH => dvayahan + aR
DArmiRam => Darmin + aR
pARinaH => paRin + aR
pAtatriRaH => patatrin + aR
mAdriRaH => madrin + aR
rAkzoGRaH => rakzohan + aR
rAjanaH => rAjan + aR
vAjriRaH => vajrin + aR
vArmaRaH => varman + aR
vEdvanaH => vidvan + aR
vEsAraH => visArin + aR
zOqanaH => zoqan + aR
sAMkUwinaH => sAMkUwin + aR
sAMdrAviRaH => sAMdrAvin + aR
sAMmArjinaH => sAMmArjin + aR
sAMrAviRaH => sAMrAvin + aR
sANkUwinaH => sANkUwin + aR
sAndrAviRaH => sAndrAvin + aR
sAmmArjinaH => sAmmArjin + aR
sOtvanaH => sutvan + aR
sEvAlaH => sevAlin + aR
sOmApUzRaH => somApUzan + aR
hAstinaH => hastin + aR
AzwuBaH => azwuB + aR
cAkzusaH => cakzus + aR
CAndasaH => Candas + aR
tApasaH => tapas + aR
rAkzasaH => rakzas + aR
rARDasaH => ranDas + aR
vAyasaH => vayas + aR
ABiziktaH => aBizikta + aY
ArkajUzaH => arkajUza + aY
ArkalUzaH => arkalUza + aY
AlasaH => alasa + aY
AvasAnaH => avasAna + aY
ASvAvatAnaH => aSvAvatAna + aY
EtaraH => itara + aY
OqupaH => uqupa + aY
OttamaH => uttama + aY
OtpuwaH => utpuwa + aY
OdapAnaH => udapAna + aY
OdasTAnaH => udasTAna + aY
OdumbaraH => udumbara + aY
OdvepaH => udvepa + aY
OrvaH => urva + aY
OlUkam => ulUka + aY
OSInaraH => uSInara + aY
OzwraH => uzwra + aY
ArtaBAgaH => ftaBAga + aY
ArzizeRaH => fzizeRa + aY
kAMsaH => kaMsa + aY
kAkandI => kakanda + aY
kARwakAraH => kaRwakAra + aY
kARqaDAraH => kaRqaDAra + aY
kAndarpaH => kandarpa + aY
kApitTaH => kapitTa + aY
kApilavaratraH => kapilavaratra + aY
kArIraH => karIra + aY
kASyapaH => kaSyapa + aY
kEMdAsaH => kiMdAsa + aY
kEMnaraH => kiMnara + aY
kEdarBaH => kidarBa + aY
kElAtaH => kilAta + aY
kESoram => kiSora + aY
kOmAram => kumAra + aY
kOmBaH => kumBa + aY
kOSikaH => kuSika + aY
kOcavAraH => kUcavAra + aY
kOlAsaH => kUlAsa + aY
kErmeduraH => kErmedura + aY
kOmeduraH => kOmedura + aY
krOzwukarRaH => krozwukarRa + aY
kzOdrakamAlavI => kzudrakamAlava + aY
KAdiraH => Kadira + aY
gAmBIraH => gamBIra + aY
gAruqam => garuqa + aY
gArdaBaH => gardaBa + aY
gAvizWiraH => gavizWira + aY
gAveSaH => gaveSa + aY
gAvezaH => gaveza + aY
gAnDAraH => gAnDAra + aY
gOptaH => gupta + aY
gOpavanaH => gopavana + aY
cAraRaH => caraRa + aY
CAgalaH => Cagala + aY
jAnapadaH => janapada + aY
jAruzI => jaruza + aY
tAruRaH => taruRa + aY
tAlunaH => taluna + aY
tEttiraH => tittira + aY
trEkaRwakaH => trikaRwaka + aY
trEgartaH => trigarta + aY
dAttaH => datta + aY
dAttamitrI => dattamitra + aY
dADitTaH => daDitTa + aY
dErGavaratraH => dIrGavaratra + aY
dvEpaH => dvEpa + aY
nAkulam => nakula + aY
nAram => nara + aY
nEDAnaH => niDAna + aY
nEveSaH => niveSa + aY
nEzAdaH => nizAda + aY
nEpaH => nIpa + aY
pAYcAlaH => paYcAla + aY
pAttigaRakam => pattigaRaka + aY
pArvataH => parvata + aY
pAlASaH => palASa + aY
pAdapam => pAdapa + aY
pElukuRaH => pIlukuRa + aY
pOtraH => putra + aY
pOlAkaH => pulAka + aY
pOzkalaH => puzkala + aY
pOtikaH => pUtika + aY
pOlAsaH => pUlAsa + aY
pArzadaMSaH => pfzadaMSa + aY
prAtiboDaH => pratiboDa + aY
prEyakaH => priyaka + aY
bADyOgaH => baDyoga + aY
bArbaraH => barbara + aY
bAzkayaH => bazkaya + aY
bAhulaH => bahula + aY
BArataH => Barata + aY
BAradvAjaH => BaradvAja + aY
BAllaH => Balla + aY
BAllakIyaH => BallakIya + aY
BAjanaH => BAjana + aY
BEkzukam => Bikzuka + aY
BArtaH => Bfta + aY
BOgakaH => Bogaka + aY
BrAmaram => Bramara + aY
mAkandI => makanda + aY
mAWaraH => maWara + aY
mADyandinaH => maDyandina + aY
mAnuzam => manuza + aY
mAntram => mantra + aY
mAyUraH => mayUra + aY
mAllaH => malla + aY
mAhAnadaH => mahAnada + aY
mAhAnasaH => mahAnasa + aY
mAhAprARaH => mahAprARa + aY
mAhArajanaH => mahArajana + aY
mAlaH => mAla + aY
yAvAsaH => yavAsa + aY
rAcitaH => racita + aY
rAjataH => rajata + aY
rATaMtaraH => raTaMtara + aY
rATagaRakam => raTagaRaka + aY
rATantaraH => raTantara + aY
rATItaraH => raTItara + aY
rOhitakaH => rohitaka + aY
vAwaram => vawara + aY
vAtsodDaraRaH => vatsodDaraRa + aY
vAruRaH => varuRa + aY
vArDram => varDra + aY
vAhyaskaH => vahyaska + aY
vEkaNkataH => vikaNkata + aY
vEkaraH => vikara + aY
vEnadaH => vinada + aY
vEBItakaH => viBItaka + aY
vESvAnaraH => viSvAnara + aY
vArDaH => vfdDa + aY
SAbaraH => Sabara + aY
SAmikaH => Samika + aY
SErIzaH => SirIza + aY
SOkam => Suka + aY
SOnakaH => Sunaka + aY
SyAmAkaH => SyamAka + aY
SyAparRaH => SyAparRa + aY
SyAmAkaH => SyAmAka + aY
sAMkalaH => saMkala + aY
sAMkucitaH => saMkucita + aY
sAdyojaH => sadyoja + aY
sAlveyaH => sAlveya + aY
sEMhakarRaH => siMhakarRa + aY
sEkataH => sikata + aY
sEsaH => sIsa + aY
sOdakzaH => sudakza + aY
sOdattaH => sudatta + aY
sOnetraH => sunetra + aY
sOpiNgalaH => supiNgala + aY
sOpUtaH => supUta + aY
sOBagam => suBaga + aY
sOBUtaH => suBUta + aY
sOmaNgalaH => sumaNgala + aY
sOtaH => sUta + aY
spAndanaH => spandana + aY
hAMsam => haMsa + aY
hAritaH => harita + aY
hAryaSvaH => haryaSva + aY
KARqikam => KaRqikA + aY
yOgavaratram => yugavaratrA + aY
vAqavam => vaqavA + aY
vAratram => varatrA + aY
hAridraH => haridrA + aY
hAlabanDam => halabanDA + aY
ADvaryavaH => aDvaryu + aY
kArkawelavaH => karkawelu + aY
tEvradAravaH => tIvradAru + aY
dOzWavam => duzWu + aY
dEvadAravaH => devadAru + aY
pEtadAravaH => pItadAru + aY
pOravaH => puru + aY
BAdradAravaH => BadradAru + aY
mArqAkavaH => mfqAku + aY
mArdavaH => mfdu + aY
SEgravaH => Sigru + aY
SESavam => SiSu + aY
sOzWavam => suzWu + aY
sArpAkavaH => sfpAku + aY
Onnetram => unnetf + aY
prAtihartram => pratihartf + aY
prASAstram => praSAstf + aY
hArtram => hartf + aY
hOtram => hotf + aY
SAradvataH => Saradvat + aY
sAttvataH => sattvat + aY
AjamIQiH => ajamIQa + iY
AjIgartiH => ajIgarta + iY
ArjuniH => arjuna + iY
ASmakiH => aSmaka + iY
kArRiH => karRa + iY
kAlakUwiH => kalakUwa + iY
kOmBakAriH => kumBakAra + iY
KAqikiH => Kaqika + iY
KARqitiH => KaRqita + iY
gAqikiH => gaqika + iY
gAdiH => gada + iY
gArgiH => garga + iY
tAntuvAyiH => tantuvAya + iY
dASaraTiH => daSaraTa + iY
prAtyagraTiH => pratyagraTa + iY
prAdyumniH => pradyumna + iY
bEjiH => bIja + iY
mARqUkiH => maRqUka + iY
mAhAcittiH => mahAcitta + iY
mAhAputriH => mahAputra + iY
mOnicitiH => municita + iY
yOganDariH => yuganDara + iY
yODizWiriH => yuDizWira + iY
rAmiH => rAma + iY
lAkzaRiH => lakzaRa + iY
vEgriH => vigra + iY
vEpracitiH => vipracita + iY
SAradaRqiH => SaradaRqa + iY
SOkriH => Sukra + iY
sAmbiH => sAmba + iY
sOtaMgamiH => sutaMgama + iY
svAniH => svana + iY
kOSaliH => kuSalA + iY
cOqiH => cUqA + iY
CAgaliH => CagalA + iY
dOrmitriH => durmitrA + iY
DOvakiH => DuvakA + iY
DrOvakiH => DruvakA + iY
BAgaliH => BagalA + iY
mAdrakAriH => madrakArA + iY
OdaYcaviH => udaYcu + iY
OpanindaviH => upanindu + iY
OpabAhaviH => upabAhu + iY
OpavAkaviH => upavAku + iY
nEvAkaviH => nivAku + iY
OdaYciH => udaYc + iY
AnuhAratiH => anuharat + iY
AzwiH => azwan + iY
kzEmavfdDiH => kzemavfdDin + iY
KAranAdiH => KaranAdin + iY
nAgaramardiH => nagaramardin + iY
prAkAramardiH => prAkAramardin + iY
BAdraSarmiH => BadraSarman + iY
SAralomiH => Saraloman + iY
SArAviH => SarAvin + iY
SOviH => Svan + iY
sAptiH => saptan + iY
hAstiSIrziH => hastiSiras + iY
AMSyaH => aMSa + Rya
ANgyaH => aNga + Rya
AjamArakyaH => ajamAraka + Rya
AnunASyaH => anunASa + Rya
kAwipyaH => kawipa + Rya
kApilyaH => kapila + Rya
kASmIryaH => kaSmIra + Rya
kOwyaH => kuwa + Rya
gArgaryaH => gargara + Rya
cErantyaH => ciranta + Rya
dArByaH => darBa + Rya
dASyaH => daSa + Rya
nAlyaH => nala + Rya
nEzaDyaH => nizaDa + Rya
nEpaTyaH => nepaTya + Rya
pAYjalyaH => paYjala + Rya
pATikAryaH => paTikAra + Rya
pAlityaH => palita + Rya
pOryaH => pura + Rya
pOlinyaH => pulina + Rya
mANguzyaH => maNguza + Rya
mAnTyaH => manTa + Rya
mAlinyaH => malina + Rya
mOryaH => mura + Rya
mOQyaH => mUQa + Rya
yAmyaH => yama + Rya
yOTyaH => yUTa + Rya
yOpyaH => yUpa + Rya
rATakAryaH => raTakAra + Rya
vAqaBIkAryaH => vaqaBIkAra + Rya
vAmaraTyaH => vAmaraTa + Rya
vAvadUkyaH => vAvadUka + Rya
vEkaryaH => vikara + Rya
vEratyaH => virata + Rya
SAlInyaH => SAlIna + Rya
SAvaputryaH => SAvaputra + Rya
SErzyaH => SIrza + Rya
SOBryaH => SuBra + Rya
SOrpaRAyyaH => SUrpaRAya + Rya
SyAvanAyyaH => SyAvanAya + Rya
SyAvaputryaH => SyAvaputra + Rya
SyAvaraTyaH => SyAvaraTa + Rya
sAMkASyaH => saMkASa + Rya
sAkarRakyaH => sakarRaka + Rya
sAtyaMkAryaH => satyaMkAra + Rya
sAmalyaH => samala + Rya
sAmIryaH => samIra + Rya
sAmrAjyaH => samrAja + Rya
sArakyaH => saraka + Rya
sEryaH => sIra + Rya
sOryaH => sUra + Rya
sOrasenyaH => sUrasena + Rya
nAsyaH => nAsA + Rya
SAlAkyaH => SAlAkA + Rya
AgastyaH => agasti + Rya
kApiYjalAdyaH => kApiYjalAdi + Rya
gARakAryaH => gaRakAri + Rya
dAmozRIzyaH => dAmozRIzi + Rya
prAjApatyaH => prajApati + Rya
mAtyaH => mati + Rya
vAnaspatyaH => vanaspati + Rya
vEmatyaH => vimati + Rya
EndrajAlyaH => indrajAlI + Rya
SAkanDavyaH => SakanDu + Rya
kArtryaH => kartf + Rya
pArzadyaH => parzad + Rya
prAgadyaH => pragadin + Rya
lOmyaH => loman + Rya
AgastyaH => agastya + yaY
AjyaH => aja + yaY
AdarakyaH => adaraka + yaY
ABayajAtyaH => aBayajAta + yaY
ArarakyaH => araraka + yaY
AvawyaH => avawa + yaY
ASmaraTyaH => aSmaraTa + yaY
OlUkyaH => ulUka + yaY
ElAkyaH => elAka + yaY
kARvyaH => kaRva + yaY
kAtyaH => kata + yaY
kATakyaH => kaTaka + yaY
kAnTakyaH => kanTaka + yaY
kApikatyaH => kapikata + yaY
kOrukAtyaH => kurukata + yaY
kEdAryam => kedAra + yaY
kESyam => keSa + yaY
gOkakzyaH => gokakza + yaY
cARakyaH => caRaka + yaY
cAmasyaH => camasa + yaY
cEkitsityaH => cikitsita + yaY
cOlukyaH => culuka + yaY
cEkityaH => cekita + yaY
jAtUkarRyaH => jatUkarRa + yaY
jAramARyaH => jaramARa + yaY
jAtUkarRyaH => jAtUkarRa + yaY
tARqyaH => taRqa + yaY
tArukzyaH => tarukza + yaY
tAlukzyaH => talukza + yaY
tEtikzyaH => titikza + yaY
tArkzyaH => tfkza + yaY
dAlByaH => dalBa + yaY
DAnaMjayyaH => DanaMjaya + yaY
pArASaryaH => parASara + yaY
pArRavalkyaH => parRavalka + yaY
pENgalyaH => piNgala + yaY
pOtimAzyaH => pUtimAza + yaY
prAcInayogyaH => prAcInayoga + yaY
bODyaH => boDa + yaY
BAqityaH => Baqita + yaY
BARqityaH => BaRqita + yaY
BEzRajyaH => BizRaja + yaY
mAntrityaH => mantrita + yaY
mAhityaH => mahita + yaY
mOsalyaH => musala + yaY
yAjYavalkyaH => yajYavalka + yaY
rAhUgaRyaH => rahUgaRa + yaY
rEByaH => reBa + yaY
lOhityaH => lohita + yaY
vAtaRqyaH => vataRqa + yaY
vAtsyaH => vatsa + yaY
vArRakyaH => varRaka + yaY
vErohityaH => virohita + yaY
vArkzyaH => vfkza + yaY
vArzagaRyaH => vfzagaRa + yaY
SAkalyaH => Sakala + yaY
SANKyaH => SaNKa + yaY
SAwyaH => Sawa + yaY
SARqilyaH => SaRqila + yaY
SArkarAkzyaH => SarkarAkza + yaY
sAMSityaH => saMSita + yaY
jAmadagnyaH => jamadagni + yaY
sAMkftyaH => saMkfti + yaY
kOwIgavyaH => kuwIgu + yaY
gARqavyaH => gaRqu + yaY
jEgIzavyaH => jigIzu + yaY
tAnavyaH => tanu + yaY
tAntavyaH => tantu + yaY
bABravyaH => baBru + yaY
mANkzavyaH => maNkzu + yaY
mARqavyaH => maRqu + yaY
mADavyaH => maDu + yaY
mAntavyaH => mantu + yaY
vAlgavyaH => valgu + yaY
vESvAvasavyaH => viSvAvasu + yaY
SANkavyaH => SaNku + yaY
sOlohyaH => sulohin + yaY
bAhyaH => bahis + yaY
mAnasyaH => manas + yaY
AgnizwomikaH => agnizwoma + WaY
AcyutikaH => acyuta + WaY
AjapaTikaH => ajapaTa + WaY
AnugrAmikaH => anugrAma + WaY
AntargehikaH => antargeha + WaY
AntarveSmikaH => antarveSma + WaY
ApUpikaH => apUpa + WaY
AriMdamikaH => ariMdama + WaY
AritrikaH => aritra + WaY
ArDamAsikaH => arDamAsa + WaY
AkrandikaH => Akranda + WaY
ApatkAlikaH => ApatkAla + WaY
OttarapaTikaH => uttarapaTa + WaY
OparAjikaH => uparAja + WaY
OpavAsikaH => upavAsa + WaY
OrDvandamikaH => UrDvandama + WaY
EkasahasrikaH => ekasahasra + WaY
kAraRikaH => karaRa + WaY
kArRavezwakikaH => karRavezwaka + WaY
kAntArapaTikaH => kAntArapaTa + WaY
kAlikaH => kAla + WaY
kOlmAzikaH => kulmAza + WaY
krOSaSatikaH => kroSaSata + WaY
gOqikaH => guqa + WaY
gOpucCikaH => gopucCa + WaY
gOvAsanikaH => govAsana + WaY
gOSatikaH => goSata + WaY
gOsahasrikaH => gosahasra + WaY
cAndrAyaRikaH => cAndrAyaRa + WaY
CAgamitrikaH => CAgamitra + WaY
jANgalapaTikaH => jaNgalapaTa + WaY
tAtkAlikaH => tatkAla + WaY
tOrAyaRikaH => turAyaRa + WaY
dAkziRArDikaH => dakziRArDa + WaY
dARqAjinikaH => daRqAjina + WaY
dASagrAmikaH => daSagrAma + WaY
dASOdanikaH => daSOdana + WaY
dAsamitrikaH => dAsamitra + WaY
dEvadattikaH => devadatta + WaY
dEvarAjikaH => devarAja + WaY
dvAdaSAhikaH => dvAdaSAha + WaY
nAtAnatikaH => natAnata + WaY
nAvayajYikaH => navayajYa + WaY
nEvAsikaH => nivAsa + WaY
nEzkaSatikaH => nizkaSata + WaY
nEzkasahasrikaH => nizkasahasra + WaY
nEzpezikaH => nizpeza + WaY
nEsargikaH => nisarga + WaY
nOpurikaH => nUpura + WaY
pAYcOdanikaH => paYcOdana + WaY
pAraSvaDikaH => paraSvaDa + WaY
pArigrAmikaH => parigrAma + WaY
pAkayajYikaH => pAkayajYa + WaY
pArAyaRikaH => pArAyaRa + WaY
prAdozikaH => pradoza + WaY
prAvAsikaH => pravAsa + WaY
prAsTikaH => prasTa + WaY
prOzWapadikaH => prozWapada + WaY
mAMsikaH => mAMsa + WaY
mAMsOdanikaH => mAMsOdana + WaY
mOdanikaH => modana + WaY
mOdamAnikaH => modamAna + WaY
yOjanikaH => yojana + WaY
yOjanaSatikaH => yojanaSata + WaY
rAjasUyikaH => rAjasUya + WaY
lAvaRikaH => lavaRa + WaY
lOkikaH => loka + WaY
vArzikaH => varza + WaY
vArzaSatikaH => varzaSata + WaY
vAsantikaH => vasanta + WaY
vAstrayugikaH => vastrayuga + WaY
vAjapeyikaH => vAjapeya + WaY
vAripaTikaH => vAripaTa + WaY
vEsargikaH => visarga + WaY
SAkulAdikaH => SakulAda + WaY
SANkupaTikaH => SaNkupaTa + WaY
SOrpikaH => SUrpa + WaY
SOvAvatAnikaH => SOvAvatAna + WaY
SvAgaRikaH => SvagaRa + WaY
zAtvaRatvikaH => zatvaRatva + WaY
sAMkrAmikaH => saMkrAma + WaY
sAMgrAmikaH => saMgrAma + WaY
sAMGAtikaH => saMGAta + WaY
sAMNGAtikaH => saMNGAta + WaY
sAMtApikaH => saMtApa + WaY
sAMnAhikaH => saMnAha + WaY
sAMparAyikaH => saMparAya + WaY
sAMpezikaH => saMpeza + WaY
sAMmodanikaH => saMmodana + WaY
sAMyogikaH => saMyoga + WaY
sAMvatsarikaH => saMvatsara + WaY
sAMvAsikaH => saMvAsa + WaY
sAMvAhikaH => saMvAha + WaY
sAMveSanikaH => saMveSana + WaY
sAMvezikaH => saMveza + WaY
sAMSayikaH => saMSaya + WaY
sADamitrikaH => saDamitra + WaY
sAntApikaH => santApa + WaY
sAmayikaH => samaya + WaY
sAmAnikaH => samAna + WaY
sAmAnagrAmikaH => samAnagrAma + WaY
sAmAnadeSikaH => samAnadeSa + WaY
sArgikaH => sarga + WaY
sArvalOkikaH => sarvaloka + WaY
sADamitrikaH => sADamitra + WaY
sEnDumitrikaH => sinDumitra + WaY
sODAmitrikaH => suDAmitra + WaY
sOmamitrikaH => somamitra + WaY
sTAlapaTikaH => sTalapaTa + WaY
cEdikaH => cedi + WaY
BAraNgikaH => BAraNgi + WaY
vEdikaH => vedi + WaY
sAMyAtikaH => sAMyAti + WaY
hAstikarzukaH => hastikarzU + WaY
BrAtfkaH => BrAtf + WaY
hOtfkaH => hotf + WaY
AkzikaH => akza + Wak
AkzadyUtikaH => akzadyUta + Wak
AgnizwomikaH => agnizwoma + Wak
AgraBojanikaH => agraBojana + Wak
AtyayikaH => atyaya + Wak
ADarmikaH => aDarma + Wak
ADyAtmikaH => aDyAtma + Wak
ADvarikaH => aDvara + Wak
AnukalpikaH => anukalpa + Wak
AnukUlikaH => anukUla + Wak
AnugatikaH => anugata + Wak
AnuguRikaH => anuguRa + Wak
AnupadikaH => anupada + Wak
AnulomikaH => anuloma + Wak
AnvIpikaH => anvIpa + Wak
ApUpikaH => apUpa + Wak
AyaHSUlikaH => ayaHSUla + Wak
ArDavAhanikaH => arDavAhana + Wak
ASvatTikaH => aSvatTa + Wak
ASvalakzaRikaH => aSvalakzaRa + Wak
AkarikaH => Akara + Wak
AkrandikaH => Akranda + Wak
AKyAtikaH => AKyAta + Wak
ATarvaRikaH => ATarvaRa + Wak
ApaRikaH => ApaRa + Wak
AyurdevikaH => Ayurdeva + Wak
OkTikaH => ukTa + Wak
OqupikaH => uqupa + Wak
OttarapadikaH => uttarapada + Wak
OtpannikaH => utpanna + Wak
OtpuwikaH => utpuwa + Wak
OtputikaH => utputa + Wak
OtsaNgikaH => utsaNga + Wak
OdarikaH => udara + Wak
OpakaraRikaH => upakaraRa + Wak
OpacArikaH => upacAra + Wak
OpaveSikaH => upaveSa + Wak
OpasTikaH => upasTa + Wak
OpasTAnikaH => upasTAna + Wak
OpahastikaH => upahasta + Wak
kARikaH => kaRa + Wak
kARwakamardanikaH => kaRwakamardana + Wak
kArRagrAhikaH => karRagrAha + Wak
kArdamikaH => kardama + Wak
kArmikaH => karma + Wak
kAlpasUtrikaH => kalpasUtra + Wak
kAtavikaH => kAtava + Wak
kOkudAkzikaH => kukudAkza + Wak
kOkkuwAkzikaH => kukkuwAkza + Wak
kORqalikaH => kuRqala + Wak
kOliSikaH => kuliSa + Wak
kOwikaH => kUwa + Wak
krAmetarikaH => krametara + Wak
KAlikaH => Kala + Wak
gARikaH => gaRa + Wak
gAtAgatikaH => gatAgata + Wak
gAtAnugatikaH => gatAnugata + Wak
gORikaH => guRa + Wak
gOrutalpikaH => gurutalpa + Wak
gOlmikaH => gulma + Wak
gOmaTikaH => gomaTa + Wak
gOlakzaRikaH => golakzaRa + Wak
GAsakundikaH => GAsakunda + Wak
cAkrikaH => cakra + Wak
cAtuzpaTikaH => catuzpaTa + Wak
cAramikaH => carama + Wak
cAmaragrAhikaH => cAmaragrAha + Wak
jANGAprahatikaH => jaNGAprahata + Wak
jANGAprahftikaH => jaNGAprahfta + Wak
jAnavAdikaH => janavAda + Wak
jAnevAdikaH => janevAda + Wak
jAnovAdikaH => janovAda + Wak
jAnuprahftikaH => jAnuprahfta + Wak
jAlikaH => jAla + Wak
jyOtizikaH => jyotiza + Wak
JArJarikaH => JarJara + Wak
tArRabindavikaH => tArRabindava + Wak
tEttirikaH => tittira + Wak
trEguRikaH => triguRa + Wak
dARqikaH => daRqa + Wak
dARqagrAhikaH => daRqagrAha + Wak
dARqamATikaH => daRqamATa + Wak
dArdurikaH => dardura + Wak
dASagrAmikaH => daSagrAma + Wak
dEzwikaH => dizwa + Wak
drORikaH => droRa + Wak
dvEguRikaH => dviguRa + Wak
DAnurdaRqikaH => DanurdaRqa + Wak
DArmamATikaH => DarmamATa + Wak
nAgarikaH => nagara + Wak
nAmikaH => nAma + Wak
nAmAKyAtikaH => nAmAKyAta + Wak
nEkawikaH => nikawa + Wak
nEruktikaH => nirukta + Wak
nEzkikaH => nizka + Wak
pARikaH => paRa + Wak
pARavikaH => paRava + Wak
pAdakramikaH => padakrama + Wak
pAradArikaH => paradAra + Wak
pAraSvaDikaH => paraSvaDa + Wak
pArASarakalpikaH => parASarakalpa + Wak
pAripanTikaH => paripanTa + Wak
pArimuKikaH => parimuKa + Wak
pAryAptikaH => paryApta + Wak
pAdikaH => pAda + Wak
pAdasvedanikaH => pAdasvedana + Wak
pAyasikaH => pAyasa + Wak
pEwakikaH => piwaka + Wak
pEwAkikaH => piwAka + Wak
pOnaruktikaH => punarukta + Wak
pOraScaraRikaH => puraScaraRa + Wak
pOrARikaH => purARa + Wak
pOrvapadikaH => pUrvapada + Wak
prAtikaRWikaH => pratikaRWa + Wak
prAtikUlikaH => pratikUla + Wak
prAtipaTikaH => pratipaTa + Wak
prAtilomikaH => pratiloma + Wak
prAtIpikaH => pratIpa + Wak
prATamikaH => praTama + Wak
prABftikaH => praBfta + Wak
prAstArikaH => prastAra + Wak
prAsikaH => prAsa + Wak
prEzaRikaH => prezaRa + Wak
bAdarikaH => badara + Wak
brAhmaRikaH => brAhmaRa + Wak
BAktikaH => Bakta + Wak
BArujikaH => Baruja + Wak
mAqqukikaH => maqquka + Wak
mARqarikaH => maRqara + Wak
mARqalikaH => maRqala + Wak
mAtsikaH => matsya + Wak
mADukarRikaH => maDukarRa + Wak
mAyUrikaH => mayUra + Wak
mAricikaH => marica + Wak
mAtfkalpikaH => mAtfkalpa + Wak
mAzikaH => mAza + Wak
mEnikaH => mIna + Wak
mOnisTalikaH => munisTala + Wak
mArdaNgikaH => mfdaNga + Wak
mOdakikaH => modaka + Wak
yAjYikaH => yajYa + Wak
yAvakrItikaH => yavakrIta + Wak
yAtopayAtikaH => yAtopayAta + Wak
rATakArikaH => raTakAra + Wak
rOhikaH => ruha + Wak
lAkzikaH => lakza + Wak
lAlAwikaH => lalAwa + Wak
lAlAmikaH => lalAma + Wak
vAMSakaWinikaH => vaMSakaWina + Wak
vArDrakaWinikaH => varDrakaWina + Wak
vArzikaH => varza + Wak
vAsantikaH => vasanta + Wak
vAjapeyikaH => vAjapeya + Wak
vAhikaH => vAha + Wak
vAhanikaH => vAhana + Wak
vEdyAmATikaH => vidyAmATa + Wak
vEnayikaH => vinaya + Wak
vESezikaH => viSeza + Wak
vArkagrAhikaH => vfkagrAha + Wak
vEtanikaH => vetana + Wak
vESikaH => veSa + Wak
vyAvahArikaH => vyavahAra + Wak
SAkawikaH => Sakawa + Wak
SAkalikaH => Sakala + Wak
SAkunikaH => Sakuna + Wak
SAbdikaH => Sabda + Wak
SArIrikaH => SarIra + Wak
SErIzikaH => SirIza + Wak
SESirikaH => SiSira + Wak
SOcikarRikaH => SucikarRa + Wak
SOlkamATikaH => SulkamATa + Wak
SmASAnikaH => SmaSAna + Wak
SyAmakikaH => SyAmaka + Wak
SlAkzikaH => Slakza + Wak
SlAkzRikaH => SlakzRa + Wak
sAMgrahikaH => saMgraha + Wak
sAMgrahasUtrikaH => saMgrahasUtra + Wak
sAMGawikaH => saMGawa + Wak
sAMGawwikaH => saMGawwa + Wak
sAMniveSikaH => saMniveSa + Wak
sAMsTAnikaH => saMsTAna + Wak
sAmayikaH => samaya + Wak
sAmayAcArikaH => samayAcAra + Wak
sAmavAyikaH => samavAya + Wak
sAmAcArikaH => samAcAra + Wak
sAmAjikaH => samAja + Wak
sAmAyikaH => samAya + Wak
sAmutkarzikaH => samutkarza + Wak
sAmUhikaH => samUha + Wak
sAmpradAnikaH => sampradAna + Wak
sAraNgikaH => saraNga + Wak
sErikaH => sIra + Wak
sOKikaH => suKa + Wak
sOKaSAyanikaH => suKaSayana + Wak
sOsnAtikaH => susnAta + Wak
sOkarikaH => sUkara + Wak
sOpikaH => sUpa + Wak
sPEjikaH => sPija + Wak
hAriRikaH => hariRa + Wak
hAlikaH => hala + Wak
kATikaH => kaTA + Wak
kAnTikaH => kanTA + Wak
cArcikaH => carcA + Wak
dvEpadikaH => dvipadA + Wak
vAyasavidyikaH => vAyasavidyA + Wak
vAsavadattikaH => vAsavadattA + Wak
vEkaTikaH => vikaTA + Wak
vESvakaTikaH => viSvakaTA + Wak
SAyyikaH => SayyA + Wak
SArkarikaH => SarkarA + Wak
SrAvaRikaH => SravaRA + Wak
sAMkaTikaH => saMkaTA + Wak
sAMhitikaH => saMhitA + Wak
sArpavidyikaH => sarpavidyA + Wak
sOmanottarikaH => sumanottarA + Wak
ANgulikaH => aNguli + Wak
ABrikaH => aBri + Wak
AsikaH => asi + Wak
OpanIvikaH => upanIvi + Wak
kApikaH => kapi + Wak
BAgavittikaH => BAgavitti + Wak
vArtikaH => vftti + Wak
SAktikaH => Sakti + Wak
SAzkulikaH => Sazkuli + Wak
SAlmalikaH => SAlmali + Wak
zAzwikaH => zazwi + Wak
sAMgatikaH => saMgati + Wak
sAMpratikaH => saMprati + Wak
sOKarAtrikaH => suKarAtri + Wak
hArikaH => hari + Wak
kArttikikaH => kArttikI + Wak
gArgikaH => gArgI + Wak
cAturdaSikaH => caturdaSI + Wak
pAdavikaH => padavI + Wak
PAlgunikaH => PAlgunI + Wak
yAvakrItikaH => yavakrItI + Wak
SAzkulikaH => SazkulI + Wak
bABrukaH => baBru + Wak
vAlgukaH => valgu + Wak
SAbarajambukaH => Sabarajambu + Wak
SAlAlukaH => SalAlu + Wak
sAktukam => saktu + Wak
pAYcahotfkaH => paYcahotf + Wak
kATaMcitkaH => kaTaMcit + Wak
BAvatkaH => Bavat + Wak
SAratkaH => Sarat + Wak
kOzwavitkaH => kuzwavid + Wak
SAratkaH => Sarad + Wak
ATarvikaH => aTarvan + Wak
hAstikam => hastin + Wak
AkASAyeyaH => akASAya + Qak
AjireyaH => ajira + Qak
ARIveyaH => aRIva + Qak
AnyatareyaH => anyatara + Qak
kArpUreyaH => karpUra + Qak
kOzItakeyaH => kuzItaka + Qak
KAqUreyaH => KaqUra + Qak
jYAtaleyaH => jYAtala + Qak
tOdeyaH => tuda + Qak
dOzkuleyaH => duzkula + Qak
pAvazwurikeyaH => pavazwurika + Qak
pOreyaH => pura + Qak
bEjeyaH => bIja + Qak
brAhmakfteyaH => brahmakfta + Qak
BArateyaH => Barata + Qak
BArameyaH => Barama + Qak
mARqUkeyaH => maRqUka + Qak
lEKABreyaH => leKABra + Qak
vAyudatteyaH => vAyudatta + Qak
vEkarReyaH => vikarRa + Qak
vEgreyaH => vigra + Qak
vESeyaH => viSa + Qak
vEzweyaH => vizwa + Qak
vEzwapureyaH => vizwapura + Qak
SAkaleyaH => Sakala + Qak
SAtadvAreyaH => SatadvAra + Qak
SAtaleyaH => Satala + Qak
SAtAhareyaH => SAtAhara + Qak
SAlATaleyaH => SAlATala + Qak
SAlUkeyaH => SAlUka + Qak
SOkeyaH => Suka + Qak
SOkreyaH => Sukra + Qak
SOBreyaH => SuBra + Qak
SyAmeyaH => SyAma + Qak
sOdakzeyaH => sudakza + Qak
sOdanteyaH => sudanta + Qak
ASokeyaH => aSokA + Qak
kESorikeyaH => kiSorikA + Qak
kOberikeyaH => kuberikA + Qak
KAqonmatteyaH => KaqonmattA + Qak
gAnDapiNgaleyaH => ganDapiNgalA + Qak
dArveyaH => dArvA + Qak
pAWeyaH => pAWA + Qak
bAhurAjeyaH => bahurAjA + Qak
mAyeyaH => mAyA + Qak
vAqabeyaH => vaqabA + Qak
vEkaMseyaH => vikaMsA + Qak
vEDaveyaH => viDavA + Qak
SAlAkeyaH => SalAkA + Qak
AjavasteyaH => ajavasti + Qak
AtiTeyaH => atiTi + Qak
AtreyaH => atri + Qak
kAleyaH => kali + Qak
dOleyaH => duli + Qak
pAriDeyaH => pariDi + Qak
vEstreyaH => vistri + Qak
SAkaMDeyaH => SakaMDi + Qak
SAkuneyaH => Sakuni + Qak
SAleyam => SAli + Qak
kASapareyaH => kASaparI + Qak
kASaPareyaH => kASaParI + Qak
KAdireyaH => KAdirI + Qak
tOdeyaH => tudI + Qak
DArmiReyaH => DarmiRI + Qak
pAvaneyaH => pAvanI + Qak
prAmAtreyaH => pramAtrI + Qak
bAlIvardineyaH => balIvardI + Qak
mAheyaH => mahI + Qak
vAnakOSAmbeyaH => vanakOSAmbI + Qak
SArNgaraveyaH => SArNgaravI + Qak
SrAvasteyaH => SrAvastI + Qak
sEtakeyaH => setakI + Qak
kAdreyaH => kadru + Qak
mAkazweyaH => makazwu + Qak
sArtaRqeyaH => sftaRqu + Qak
mAdrabAheyaH => madrabAhU + Qak
SAlAkABreyaH => SalAkABrU + Qak
AnudfzweyaH => anudfzwin + Qak
bAlIvardeyaH => balIvardin + Qak
sOdAmeyaH => sudAman + Qak
AgnidatteyaH => agnidatta + QaY
kAdaleyaH => kadala + QaY
kAravIreyaH => karavIra + QaY
kOSIrakeyaH => kuSIraka + QaY
gOpileyaH => gopila + QaY
cAkreyaH => cakra + QaY
cAkravAkeyaH => cakravAka + QaY
CAgaleyaH => Cagala + QaY
tAmAleyaH => tamAla + QaY
BAlleyaH => Balla + QaY
BAllapAleyaH => BallapAla + QaY
rOheyaH => roha + QaY
vAjreyaH => vajra + QaY
vAyudatteyaH => vAyudatta + QaY
vAsaveyaH => vAsava + QaY
vEreyaH => vIra + QaY
SEhareyaH => SIhara + QaY
sAptaleyaH => saptala + QaY
sAmareyaH => samara + QaY
sAmaleyaH => samala + QaY
sArakeyaH => saraka + QaY
sAraseyaH => sarasa + QaY
sEhareyaH => sIhara + QaY
sOraseyaH => surasa + QaY
AjavasteyaH => ajavasti + QaY
AsteyaH => asti + QaY
AheyaH => ahi + QaY
kAlaSeyam => kalaSi + QaY
kOkzeyam => kukzi + QaY
dArteyam => dfti + QaY
bAleyaH => bali + QaY
vAsateyam => vasati + QaY
vAsteyaH => vasti + QaY
svApateyam => svapati + QaY
hAleyaH => hali + QaY
hArzweyaH => hfzwi + QaY
AruRaparAjI => aruRaparAja + Rini
kAWI => kaWa + Rini
kAWaSAWI => kaWaSAWa + Rini
kAmalI => kamala + Rini
KAqAyanI => KAqAyana + Rini
tAlI => tala + Rini
tARqyI => tARqya + Rini
dARqI => daRqa + Rini
pAlaNgI => palaNga + Rini
rAjjukaRWI => rajjukaRWa + Rini
rAjjuBArI => rajjuBAra + Rini
vAjasaneyI => vAjasaneya + Rini
SAwyAyanI => SAwyAyana + Rini
SApeyI => SApeya + Rini
SArNgaravI => SArNgarava + Rini
SAzpeyI => SAzpeya + Rini
SOnakI => SOnaka + Rini
SyAmAyanI => SyAmAyana + Rini
skAndI => skanda + Rini
stAmBI => stamBa + Rini
AruRI => AruRi + Rini
BAllavI => Ballu + Rini
aNgAritaH => aNgAra + itac
aNgArakitaH => aNgAraka + itac
anDakAritaH => anDakAra + itac
aBritaH => aBra + itac
uccAritaH => uccAra + itac
kajjalitaH => kajjala + itac
kaYcukitaH => kaYcuka + itac
kandalitaH => kandala + itac
karRakitaH => karRaka + itac
kardamitaH => kardama + itac
kalaNkitaH => kalaNka + itac
kallolitaH => kallola + itac
kisalayitaH => kisalaya + itac
kuqmalitaH => kuqmala + itac
kutUhalitaH => kutUhala + itac
kumuritaH => kumura + itac
kuvalayitaH => kuvalaya + itac
kusumitaH => kusuma + itac
korakitaH => koraka + itac
kzaRitaH => kzaRa + itac
KaRqitaH => KaRqa + itac
garitaH => gara + itac
garjitaH => garja + itac
garDitaH => garDa + itac
garBitaH => garBa + itac
garvitaH => garva + itac
candrakitaH => candraka + itac
jvaritaH => jvara + itac
taraMgitaH => taraMga + itac
tilakitaH => tilaka + itac
duHKitaH => duHKa + itac
dohitaH => doha + itac
drohitaH => droha + itac
nizkramaRitaH => nizkramaRa + itac
pallavitaH => pallava + itac
purIzitaH => purIza + itac
pulakitaH => pulaka + itac
pracAritaH => pracAra + itac
pratibimbitaH => pratibimba + itac
pratyayitaH => pratyaya + itac
PalitaH => Pala + itac
bakulitaH => bakula + itac
BaritaH => Bara + itac
mukuritaH => mukura + itac
mukulitaH => mukula + itac
musalitaH => musala + itac
mUtritaH => mUtra + itac
raRitaH => raRa + itac
rogitaH => roga + itac
varRakitaH => varRaka + itac
viGnatantritaH => viGnatantra + itac
vraRitaH => vraRa + itac
SvaBritaH => SvaBra + itac
suKitaH => suKa + itac
sUtritaH => sUtra + itac
stabakitaH => stabaka + itac
stambakitaH => stambaka + itac
stavakitaH => stavaka + itac
sTapuwitaH => sTapuwa + itac
harzitaH => harza + itac
hastakitaH => hastaka + itac
nidritaH => nidrA + itac
mudritaH => mudrA + itac
SradDitaH => SradDA + itac
akzaryaH => akzara + yat
agnIzomyaH => agnIzoma + yat
agryaH => agra + yat
aDyarDapaRyaH => aDyarDapaRa + yat
aDyarDapAdyaH => aDyarDapAda + yat
aDyarDamAzyaH => aDyarDamAza + yat
aDyarDaSatyaH => aDyarDaSata + yat
aDyarDaSARyaH => aDyarDaSARa + yat
aDvanyaH => aDvana + yat
antyaH => anta + yat
antaryaH => antara + yat
apUpyaH => apUpa + yat
aByuzyaH => aByuza + yat
aByUzyaH => aByUza + yat
aByezyaH => aByeza + yat
aByozyaH => aByoza + yat
aBryaH => aBra + yat
argalyaH => argala + yat
arTyaH => arTa + yat
arDyaH => arDa + yat
alIkyaH => alIka + yat
avozyaH => avoza + yat
aSvyaH => aSva + yat
asuryaH => asura + yat
irgalyaH => irgala + yat
odanyaH => odana + yat
kawakyaH => kawaka + yat
kaqaNkaryaH => kaqaNkara + yat
kambalyam => kambala + yat
karRavezwakyaH => karRavezwaka + yat
karmyaH => karma + yat
kAmyaH => kAma + yat
kAlyaH => kAla + yat
kiRvyaH => kiRva + yat
kfzRatilyaH => kfzRatila + yat
kzaryaH => kzara + yat
KadyaH => Kada + yat
KaryaH => Kara + yat
KalyaH => Kala + yat
gaRyaH => gaRa + yat
gfhameDyaH => gfhameDa + yat
caraRyaH => caraRa + yat
jaGanyaH => jaGana + yat
janyaH => jana + yat
jYAyyaH => jYAya + yat
taRqulyaH => taRqula + yat
tripaRyaH => tripaRa + yat
tripAdyaH => tripAda + yat
trimAzyaH => trimAza + yat
triSatyaH => triSata + yat
triSARyaH => triSARa + yat
trihalyaH => trihala + yat
daRqyaH => daRqa + yat
dantyaH => danta + yat
daryaH => dara + yat
dIptyaH => dIpta + yat
dIsyaH => dIsa + yat
dUtyam => dUta + yat
deSyaH => deSa + yat
dvipaRyaH => dvipaRa + yat
dvipAdyaH => dvipAda + yat
dvimAzyaH => dvimAza + yat
dviSatyaH => dviSata + yat
dviSARyaH => dviSARa + yat
dvihalyaH => dvihala + yat
DanyaH => Dana + yat
DarmyaH => Darma + yat
DAyyaH => DAyya + yat
nyAyyaH => nyAya + yat
pakzyaH => pakza + yat
patryaH => patra + yat
padyaH => pada + yat
pAtryaH => pAtra + yat
putryaH => putra + yat
puroqASyaH => puroqASa + yat
pUgyaH => pUga + yat
pUpyaH => pUpa + yat
pfTukyaH => pfTuka + yat
pradIpyaH => pradIpa + yat
prAsaNgyaH => prAsaNga + yat
bIjyaH => bIja + yat
brahmavarcasyaH => brahmavarcasa + yat
BaNgyaH => BaNga + yat
matyam => mata + yat
maDuparkyaH => maDuparka + yat
mAzyaH => mAza + yat
mAsyaH => mAsa + yat
mitryaH => mitra + yat
musalyaH => musala + yat
mUlyaH => mUla + yat
yavyaH => yava + yat
yavakyaH => yavaka + yat
yugyaH => yuga + yat
yUTyaH => yUTa + yat
yUpyaH => yUpa + yat
raTyaH => raTa + yat
rAjamAzyaH => rAjamAza + yat
vaMSyaH => vaMSa + yat
vaDyaH => vaDa + yat
vargyaH => varga + yat
vaSyaH => vaSa + yat
vizyaH => viza + yat
vedyaH => veda + yat
veSyaH => veSa + yat
vezyaH => veza + yat
SatyaH => Sata + yat
SaraRyaH => SaraRa + yat
SIrzacCedyaH => SIrzacCeda + yat
SunAsIryaH => SunAsIra + yat
SUlyaH => SUla + yat
SfNgyaH => SfNga + yat
SvaSuryaH => SvaSura + yat
zazwikyaH => zazwika + yat
sAdanyaH => sAdana + yat
suvarRyaH => suvarRa + yat
sUpyaH => sUpa + yat
skandyaH => skanda + yat
skanDyaH => skanDa + yat
sTAlIbilyaH => sTAlIbila + yat
svargyaH => svarga + yat
halyaH => hala + yat
hfdyaH => hfdya + yat
azwakyaH => azwakA + yat
umyam => umA + yat
kaSyaH => kaSA + yat
guhyaH => guhA + yat
dakziRyaH => dakziRA + yat
BaNgyam => BaNgA + yat
vAyudevatyaH => vAyudevatA + yat
sUryadevatyaH => sUryadevatA + yat
sKadyaH => sKadA + yat
janyA => janI + yat
kamaRqalavyA => kamaRqalu + yat
caravyaH => caru + yat
yAtavyA => yAtu + yat
vasavyam => vasu + yat
SaNkavyam => SaNku + yat
saktavyaH => saktu + yat
barhizyaH => barhiz + yat
urasyaH => uras + yat
CandasyaH => Candas + yat
tapasyaH => tapas + yat
naBasyaH => naBas + yat
payasyaH => payas + yat
yaSasyaH => yaSas + yat
rakzasyA => rakzas + yat
rahasyaH => rahas + yat
sahasyaH => sahas + yat
aNgIyaH => aNga + Ca
aNgArIyaH => aNgAra + Ca
ajirIyaH => ajira + Ca
aRakIyaH => aRaka + Ca
aDamaSAKIyaH => aDamaSAKa + Ca
anantarIyaH => anantara + Ca
anupravacanIyaH => anupravacana + Ca
anupraveSanIyaH => anupraveSana + Ca
anuvacanIyaH => anuvacana + Ca
anuvAcanIyaH => anuvAcana + Ca
anuvAsanIyaH => anuvAsana + Ca
anekIyaH => aneka + Ca
antarIyaH => antara + Ca
antasTIyaH => antasTa + Ca
anvArohaRIyaH => anvArohaRa + Ca
aparapakzIyaH => aparapakza + Ca
aByamitrIyaH => aByamitra + Ca
araRyIyaH => araRya + Ca
arIhaRIyaH => arIhaRa + Ca
arkIyaH => arka + Ca
avarohitIyaH => avarohita + Ca
avasyandanIyaH => avasyandana + Ca
aSvatTIyaH => aSvatTa + Ca
AtapIyaH => Atapa + Ca
AyuDIyaH => AyuDa + Ca
AramBaRIyaH => AramBaRa + Ca
ArdravfkzIyaH => Ardravfkza + Ca
idAvatsarIyaH => idAvatsara + Ca
idvatsarIyaH => idvatsara + Ca
indravfkzIyaH => indravfkza + Ca
izvagrIyaH => izvagra + Ca
izvanIkIyaH => izvanIka + Ca
utkarIyaH => utkara + Ca
utkroSIyaH => utkroSa + Ca
uttamaSAKIyaH => uttamaSAKa + Ca
uttarIyaH => uttara + Ca
utTApanIyaH => utTApana + Ca
upasTApanIyaH => upasTApana + Ca
ekagrAmIyaH => ekagrAma + Ca
ekapalASIyaH => ekapalASa + Ca
ekaSAKIyaH => ekaSAKa + Ca
kawanagarIyaH => kawanagara + Ca
kawapalvalIyaH => kawapalvala + Ca
kaqaNkarIyaH => kaqaNkara + Ca
kAmaprasTIyaH => kAmaprasTa + Ca
kASIyaH => kASa + Ca
kitavIyaH => kitava + Ca
kuSAgrIyaH => kuSAgra + Ca
kzAntIyaH => kzAnta + Ca
kzArIyaH => kzAra + Ca
kzudrIyaH => kzudra + Ca
KaRqIyaH => KaRqa + Ca
KadirIyaH => Kadira + Ca
KalAjinIyaH => KalAjina + Ca
KAqAyanIyaH => KAqAyana + Ca
gartIyaH => garta + Ca
gahIyaH => gaha + Ca
gOragrIvIyaH => gOragrIva + Ca
tatvagrIyaH => tatvagra + Ca
tantvagrIyaH => tantvagra + Ca
tikIyaH => tika + Ca
tulaBIyaH => tulaBa + Ca
trEvaRIyaH => trEvaRa + Ca
dantAgrIyaH => dantAgra + Ca
nitAntavfkzIyaH => nitAntavfkza + Ca
niSAntIyaH => niSAnta + Ca
nEvAkavIyaH => nEvAkava + Ca
parivatsarIyaH => parivatsara + Ca
parRIyaH => parRa + Ca
palASIyaH => palASa + Ca
picukIyaH => picuka + Ca
pippalIyaH => pippala + Ca
pippalImUlIyaH => pippalImUla + Ca
putrIyaH => putra + Ca
pUrvapakzIyaH => pUrvapakza + Ca
pENgAkzIputrIyaH => pENgAkzIputra + Ca
pradyumnAgamanIyaH => pradyumnAgamana + Ca
praveSanIyaH => praveSana + Ca
prAkArIyaH => prAkAra + Ca
prAramBaRIyaH => prAramBaRa + Ca
PalIyaH => Pala + Ca
magaDIyaH => magaDa + Ca
mantraRArhIyaH => mantraRArha + Ca
mahendrIyaH => mahendra + Ca
yamasaBIyaH => yamasaBa + Ca
vaNgIyaH => vaNga + Ca
vatsIyaH => vatsa + Ca
vatsarIyaH => vatsara + Ca
vAtAgarIyaH => vAtAgara + Ca
viSAlIyaH => viSAla + Ca
vizamIyaH => vizama + Ca
vfkagartIyaH => vfkagarta + Ca
vfkzIyaH => vfkza + Ca
vErARakIyaH => vErARaka + Ca
SaMkArIyaH => SaMkAra + Ca
SatarudrIyaH => Satarudra + Ca
SaParIyaH => SaPara + Ca
SAkIyaH => SAka + Ca
SAlIyaH => SAla + Ca
SiSukrandIyaH => SiSukranda + Ca
SunAsIrIyaH => SunAsIra + Ca
SyAvanAyIyaH => SyAvanAya + Ca
SvAvidgartIyaH => SvAvidgarta + Ca
saMparIyaH => saMpara + Ca
saMPalIyaH => saMPala + Ca
saMvatsarIyaH => saMvatsara + Ca
saMveSanIyaH => saMveSana + Ca
samIyaH => sama + Ca
samAnagrAmIyaH => samAnagrAma + Ca
samAnaSAKIyaH => samAnaSAKa + Ca
sAvitrIputrIyaH => sAvitrIputra + Ca
sTAlIbilIyaH => sTAlIbila + Ca
haMsIyaH => haMsa + Ca
janyIyaH => janyA + Ca
dakziRIyaH => dakziRA + Ca
BastrIyaH => BastrA + Ca
agnIyaH => agni + Ca
agniSarmIyaH => agniSarmi + Ca
acyutadantIyaH => acyutadanti + Ca
acyutantIyaH => acyutanti + Ca
AcyutadantIyaH => Acyutadanti + Ca
AcyutantIyaH => Acyutanti + Ca
ADyaSvIyaH => ADyaSvi + Ca
AnfSaMsIyaH => AnfSaMsi + Ca
AmitrIyaH => Amitri + Ca
AhiMsIyaH => AhiMsi + Ca
OqavIyaH => Oqavi + Ca
OdaNkIyaH => OdaNki + Ca
OdameDIyaH => OdameDi + Ca
OdavApIyaH => OdavApi + Ca
OlapIyaH => Olapi + Ca
kAkadantakIyaH => kAkadantaki + Ca
kAkandIyaH => kAkandi + Ca
kAWeraRIyaH => kAWeraRi + Ca
kzEmavfdDIyaH => kzEmavfdDi + Ca
gOragrIvIyaH => gOragrIvi + Ca
dAmanIyaH => dAmani + Ca
bEjavApIyaH => bEjavApi + Ca
BOjIyaH => BOji + Ca
yAmundAyanIyaH => yAmundAyani + Ca
lAveraRIyaH => lAveraRi + Ca
vArawakIyaH => vArawaki + Ca
vAstozpatIyaH => vAstozpati + Ca
vEjIyaH => vEji + Ca
vyAqIyaH => vyAqi + Ca
SAkuntakIyaH => SAkuntaki + Ca
SAtruMtapIyaH => SAtruMtapi + Ca
SESirIyaH => SESiri + Ca
SONgIyaH => SONgi + Ca
SrOtIyaH => SrOti + Ca
sArvasenIyaH => sArvaseni + Ca
svApiSIyaH => svApiSi + Ca
tizyapunarvasavIyaH => tizyapunarvasu + Ca
aponaptrIyaH => aponaptf + Ca
akiMcanatvam => akiMcana + tva
akzetrajYatvam => akzetrajYa + tva
acCAvAkatvam => acCAvAka + tva
ajAnikatvam => ajAnika + tva
aYjanikatvam => aYjanika + tva
aYjalikatvam => aYjalika + tva
anISvaratvam => anISvara + tva
anukUlatvam => anukUla + tva
anfSaMsatvam => anfSaMsa + tva
anyaBAvatvam => anyaBAva + tva
aparADayatvam => aparADaya + tva
apiSunatvam => apiSuna + tva
aBirUpatvam => aBirUpa + tva
aBIkzRatvam => aBIkzRa + tva
amuzyakulatvam => amuzyakula + tva
amuzyaputratvam => amuzyaputra + tva
ayaTApuratvam => ayaTApura + tva
ayaTAyaTatvam => ayaTAyaTa + tva
alasatvam => alasa + tva
avaSyaputratvam => avaSyaputra + tva
avikatvam => avika + tva
aviduratvam => avidura + tva
aSvatvam => aSva + tva
AgnIDratvam => AgnIDra + tva
AQyatvam => AQya + tva
Amratvam => Amra + tva
Astikatvam => Astika + tva
ucitatvam => ucita + tva
uttarADaratvam => uttarADara + tva
udAsInatvam => udAsIna + tva
uparADayatvam => uparADaya + tva
uzwratvam => uzwra + tva
ekaBAvatvam => ekaBAva + tva
kawukatvam => kawuka + tva
kaWatvam => kaWa + tva
karmikatvam => karmika + tva
kalApatvam => kalApa + tva
kalyARatvam => kalyARa + tva
kazwatvam => kazwa + tva
kApuruzatvam => kApuruza + tva
kAyatvam => kAya + tva
kAryatvam => kArya + tva
kutukatvam => kutuka + tva
kutUhalatvam => kutUhala + tva
kuputratvam => kuputra + tva
kulaputratvam => kulaputra + tva
kuSalatvam => kuSala + tva
kfSatvam => kfSa + tva
kfzRatvam => kfzRa + tva
kOYjAyanatvam => kOYjAyana + tva
kzipratvam => kzipra + tva
kzudratvam => kzudra + tva
KaRqatvam => KaRqa + tva
KaRqikatvam => KaRqika + tva
gaqulatvam => gaqula + tva
garuqatvam => garuqa + tva
gArgyatvam => gArgya + tva
grAmakumAratvam => grAmakumAra + tva
grAmakulAlatvam => grAmakulAla + tva
grAmaqatvam => grAmaqa + tva
grAmaputratvam => grAmaputra + tva
grAmazaRqatvam => grAmazaRqa + tva
grAmikatvam => grAmika + tva
caRqatvam => caRqa + tva
capalatvam => capala + tva
carmikatvam => carmika + tva
cukratvam => cukra + tva
cUqikatvam => cUqika + tva
Catrikatvam => Catrika + tva
CAtratvam => CAtra + tva
CAndasatvam => CAndasa + tva
jaqatvam => jaqa + tva
janatvam => jana + tva
tatparatvam => tatpara + tva
tadarTatvam => tadarTa + tva
taratamatvam => taratama + tva
taruRatvam => taruRa + tva
tAmratvam => tAmra + tva
tilakatvam => tilaka + tva
triBAvatvam => triBAva + tva
triyAhanatvam => triyAhana + tva
daRqatvam => daRqa + tva
daRqikatvam => daRqika + tva
dAyAdatvam => dAyAda + tva
dInatvam => dIna + tva
durhfdayatvam => durhfdaya + tva
duzpuruzatvam => duzpuruza + tva
dUtatvam => dUta + tva
dviBAvatvam => dviBAva + tva
dvihAyanatvam => dvihAyana + tva
Darmikatvam => Darmika + tva
DUrtatvam => DUrta + tva
nayAtatvam => nayAta + tva
nAgaratvam => nAgara + tva
nAstikatvam => nAstika + tva
nipAtatvam => nipAta + tva
nizkulatvam => nizkula + tva
nIlatvam => nIla + tva
pakzigaRakatvam => pakzigaRaka + tva
pawatvam => pawa + tva
paRqitatvam => paRqita + tva
paTikatvam => paTika + tva
paramasTatvam => paramasTa + tva
parimaRqalatvam => parimaRqala + tva
parivfQatvam => parivfQa + tva
parivrAjakatvam => parivrAjaka + tva
parzikatvam => parzika + tva
pAkatvam => pAka + tva
piRqikatvam => piRqika + tva
pippalAdatvam => pippalAda + tva
piSunatvam => piSuna + tva
pItatvam => pIta + tva
putrikatvam => putrika + tva
purohitatvam => purohita + tva
pUrvAparatvam => pUrvApara + tva
prakAmatvam => prakAma + tva
pratikatvam => pratika + tva
priyatvam => priya + tva
priyarUpatvam => priyarUpa + tva
baDiratvam => baDira + tva
bahulatvam => bahula + tva
bAlatvam => bAla + tva
bAlamandatvam => bAlamanda + tva
bAliSatvam => bAliSa + tva
brAhmaRAcCaMsatvam => brAhmaRAcCaMsa + tva
Bavizyatvam => Bavizya + tva
BUtatvam => BUta + tva
BfSatvam => BfSa + tva
maDyasTatvam => maDyasTa + tva
manuzyatvam => manuzya + tva
manojYatvam => manojYa + tva
mandatvam => manda + tva
mARavatvam => mARava + tva
mAnuzatvam => mAnuza + tva
mitrAvaruRatvam => mitrAvaruRa + tva
miTunatvam => miTuna + tva
mUkatvam => mUka + tva
mUQatvam => mUQa + tva
mUlikatvam => mUlika + tva
yaTAkAmatvam => yaTAkAma + tva
yuvarAjatvam => yuvarAja + tva
raktatvam => rakta + tva
raTagaRakatvam => raTagaRaka + tva
ramaRIyatvam => ramaRIya + tva
rAjapuruzatvam => rAjapuruza + tva
rUpikatvam => rUpika + tva
lavaRatvam => lavaRa + tva
lohitatvam => lohita + tva
vakratvam => vakra + tva
vatsatvam => vatsa + tva
vartamAnatvam => vartamAna + tva
varmikatvam => varmika + tva
vasanIyatvam => vasanIya + tva
vAqavatvam => vAqava + tva
vijAtatvam => vijAta + tva
vidagDatvam => vidagDa + tva
vipAtatvam => vipAta + tva
vimanatvam => vimana + tva
viyAtatvam => viyAta + tva
virADayatvam => virADaya + tva
vilABatvam => vilABa + tva
viSAtatvam => viSAta + tva
viSAyatvam => viSAya + tva
viSAradatvam => viSArada + tva
viSvadevatvam => viSvadeva + tva
viSvarUpatvam => viSvarUpa + tva
vizamatvam => vizama + tva
vizamasTatvam => vizamasTa + tva
vfQatvam => vfQa + tva
vfdDatvam => vfdDa + tva
vfzatvam => vfza + tva
vfzalatvam => vfzala + tva
Sataputratvam => Sataputra + tva
SAkvaratvam => SAkvara + tva
Silikatvam => Silika + tva
SItatvam => SIta + tva
SIlatvam => SIla + tva
Sukratvam => Sukra + tva
Suklatvam => Sukla + tva
SOwIratvam => SOwIra + tva
SyAmatvam => SyAma + tva
SyAvatvam => SyAva + tva
SramaRatvam => SramaRa + tva
SravaRatvam => SravaRa + tva
Srotriyatvam => Srotriya + tva
Svetatvam => Sveta + tva
saMrakzatvam => saMrakza + tva
saMrakzasUcakatvam => saMrakzasUcaka + tva
samagratvam => samagra + tva
samasTatvam => samasTa + tva
samIpatvam => samIpa + tva
sarpatvam => sarpa + tva
sahAyatvam => sahAya + tva
sAraputratvam => sAraputra + tva
sukumAratvam => sukumAra + tva
suBagatvam => suBaga + tva
suhitatvam => suhita + tva
suhfdayatvam => suhfdaya + tva
sUcakatvam => sUcaka + tva
sUcikatvam => sUcika + tva
sUtikatvam => sUtika + tva
stenatvam => stena + tva
sTaviratvam => sTavira + tva
sTiratvam => sTira + tva
svaDarmatvam => svaDarma + tva
svaBAvatvam => svaBAva + tva
svarAjatvam => svarAja + tva
haritatvam => harita + tva
hfdayatvam => hfdaya + tva
hoqatvam => hoqa + tva
hrasvatvam => hrasva + tva
taTAtvam => taTA + tva
kapitvam => kapi + tva
kavitvam => kavi + tva
gaRapatitvam => gaRapati + tva
prajApatitvam => prajApati + tva
vimatitvam => vimati + tva
saMmatitvam => saMmati + tva
sAkzitvam => sAkzi + tva
sAraTitvam => sAraTi + tva
sTAyitvam => sTAyi + tva
kustrItvam => kustrI + tva
duHstrItvam => duHstrI + tva
aDvaryutvam => aDvaryu + tva
kamaRqalutvam => kamaRqalu + tva
tanutvam => tanu + tva
duzWutvam => duzWu + tva
pawutvam => pawu + tva
banDutvam => banDu + tva
bahutvam => bahu + tva
mfdutvam => mfdu + tva
laGutvam => laGu + tva
vAyutvam => vAyu + tva
suzWutvam => suzWu + tva
svAdutvam => svAdu + tva
pratiBUtvam => pratiBU + tva
unnetftvam => unnetf + tva
kartftvam => kartf + tva
tvazwftvam => tvazwf + tva
durBrAtftvam => durBrAtf + tva
potftvam => potf + tva
pratipasTAtftvam => pratipasTAtf + tva
pratihartftvam => pratihartf + tva
praSAstftvam => praSAstf + tva
hartftvam => hartf + tva
samrAwtvam => samrAj + tva
durhfttvam => durhfd + tva
niGAtitvam => niGAtin + tva
bahuBAzitvam => bahuBAzin + tva
saMBAzitvam => saMBAzin + tva
saMvAditvam => saMvAdin + tva
saMveSitvam => saMveSin + tva
sabrahmacAritvam => sabrahmacArin + tva
akiMcanatA => akiMcana + tal
akzetrajYatA => akzetrajYa + tal
acCAvAkatA => acCAvAka + tal
ajAnikatA => ajAnika + tal
aYjanikatA => aYjanika + tal
aYjalikatA => aYjalika + tal
anISvaratA => anISvara + tal
anukUlatA => anukUla + tal
anfSaMsatA => anfSaMsa + tal
anyaBAvatA => anyaBAva + tal
aparADayatA => aparADaya + tal
apiSunatA => apiSuna + tal
aBirUpatA => aBirUpa + tal
aBIkzRatA => aBIkzRa + tal
amuzyakulatA => amuzyakula + tal
amuzyaputratA => amuzyaputra + tal
ayaTApuratA => ayaTApura + tal
ayaTAyaTatA => ayaTAyaTa + tal
alasatA => alasa + tal
avaSyaputratA => avaSyaputra + tal
avikatA => avika + tal
aviduratA => avidura + tal
aSvatA => aSva + tal
AgnIDratA => AgnIDra + tal
AQyatA => AQya + tal
AmratA => Amra + tal
AstikatA => Astika + tal
ucitatA => ucita + tal
uttarADaratA => uttarADara + tal
udAsInatA => udAsIna + tal
uparADayatA => uparADaya + tal
uzwratA => uzwra + tal
ekaBAvatA => ekaBAva + tal
kawukatA => kawuka + tal
kaWatA => kaWa + tal
karmikatA => karmika + tal
kalApatA => kalApa + tal
kalyARatA => kalyARa + tal
kazwatA => kazwa + tal
kApuruzatA => kApuruza + tal
kAyatA => kAya + tal
kAryatA => kArya + tal
kutukatA => kutuka + tal
kutUhalatA => kutUhala + tal
kuputratA => kuputra + tal
kulaputratA => kulaputra + tal
kuSalatA => kuSala + tal
kfSatA => kfSa + tal
kfzRatA => kfzRa + tal
kOYjAyanatA => kOYjAyana + tal
kzipratA => kzipra + tal
kzudratA => kzudra + tal
KaRqatA => KaRqa + tal
KaRqikatA => KaRqika + tal
gaqulatA => gaqula + tal
garuqatA => garuqa + tal
gArgyatA => gArgya + tal
grAmakumAratA => grAmakumAra + tal
grAmakulAlatA => grAmakulAla + tal
grAmaqatA => grAmaqa + tal
grAmaputratA => grAmaputra + tal
grAmazaRqatA => grAmazaRqa + tal
grAmikatA => grAmika + tal
caRqatA => caRqa + tal
capalatA => capala + tal
carmikatA => carmika + tal
cukratA => cukra + tal
cUqikatA => cUqika + tal
coratA => cora + tal
CatrikatA => Catrika + tal
CAtratA => CAtra + tal
CAndasatA => CAndasa + tal
jaqatA => jaqa + tal
tatparatA => tatpara + tal
tadarTatA => tadarTa + tal
taratamatA => taratama + tal
taruRatA => taruRa + tal
tAmratA => tAmra + tal
tilakatA => tilaka + tal
triBAvatA => triBAva + tal
triyAhanatA => triyAhana + tal
daRqatA => daRqa + tal
daRqikatA => daRqika + tal
dAyAdatA => dAyAda + tal
dInatA => dIna + tal
durhfdayatA => durhfdaya + tal
duzpuruzatA => duzpuruza + tal
dUtatA => dUta + tal
dviBAvatA => dviBAva + tal
dvihAyanatA => dvihAyana + tal
DarmikatA => Darmika + tal
DUrtatA => DUrta + tal
nayAtatA => nayAta + tal
nAgaratA => nAgara + tal
nAstikatA => nAstika + tal
nipAtatA => nipAta + tal
nizkulatA => nizkula + tal
nIlatA => nIla + tal
pakzigaRakatA => pakzigaRaka + tal
pawatA => pawa + tal
paRqitatA => paRqita + tal
paTikatA => paTika + tal
paramasTatA => paramasTa + tal
parimaRqalatA => parimaRqala + tal
parivfQatA => parivfQa + tal
parivrAjakatA => parivrAjaka + tal
parzikatA => parzika + tal
pAkatA => pAka + tal
piRqikatA => piRqika + tal
pippalAdatA => pippalAda + tal
piSunatA => piSuna + tal
pItatA => pIta + tal
putrikatA => putrika + tal
purohitatA => purohita + tal
pUrvAparatA => pUrvApara + tal
prakAmatA => prakAma + tal
pratikatA => pratika + tal
priyatA => priya + tal
priyarUpatA => priyarUpa + tal
baDiratA => baDira + tal
bahulatA => bahula + tal
bAlatA => bAla + tal
bAlamandatA => bAlamanda + tal
bAliSatA => bAliSa + tal
brAhmaRAcCaMsatA => brAhmaRAcCaMsa + tal
BavizyatA => Bavizya + tal
BUtatA => BUta + tal
BfSatA => BfSa + tal
maDyasTatA => maDyasTa + tal
manuzyatA => manuzya + tal
manojYatA => manojYa + tal
mandatA => manda + tal
mARavatA => mARava + tal
mAnuzatA => mAnuza + tal
mitrAvaruRatA => mitrAvaruRa + tal
miTunatA => miTuna + tal
mUkatA => mUka + tal
mUQatA => mUQa + tal
mUlikatA => mUlika + tal
yaTAkAmatA => yaTAkAma + tal
yuvarAjatA => yuvarAja + tal
raktatA => rakta + tal
raTagaRakatA => raTagaRaka + tal
ramaRIyatA => ramaRIya + tal
rAjapuruzatA => rAjapuruza + tal
rUpikatA => rUpika + tal
lavaRatA => lavaRa + tal
lohitatA => lohita + tal
vakratA => vakra + tal
vatsatA => vatsa + tal
vartamAnatA => vartamAna + tal
varmikatA => varmika + tal
vasanIyatA => vasanIya + tal
vAqavatA => vAqava + tal
vijAtatA => vijAta + tal
vidagDatA => vidagDa + tal
vipAtatA => vipAta + tal
vimanatA => vimana + tal
viyAtatA => viyAta + tal
virADayatA => virADaya + tal
vilABatA => vilABa + tal
viSAtatA => viSAta + tal
viSAyatA => viSAya + tal
viSAradatA => viSArada + tal
viSvadevatA => viSvadeva + tal
viSvarUpatA => viSvarUpa + tal
vizamatA => vizama + tal
vizamasTatA => vizamasTa + tal
vfQatA => vfQa + tal
vfdDatA => vfdDa + tal
vfzatA => vfza + tal
vfzalatA => vfzala + tal
SataputratA => Sataputra + tal
SAkvaratA => SAkvara + tal
SilikatA => Silika + tal
SItatA => SIta + tal
SIlatA => SIla + tal
SukratA => Sukra + tal
SuklatA => Sukla + tal
SOwIratA => SOwIra + tal
SyAmatA => SyAma + tal
SyAvatA => SyAva + tal
SramaRatA => SramaRa + tal
SravaRatA => SravaRa + tal
SrotriyatA => Srotriya + tal
SvetatA => Sveta + tal
saMrakzatA => saMrakza + tal
saMrakzasUcakatA => saMrakzasUcaka + tal
samagratA => samagra + tal
samasTatA => samasTa + tal
samIpatA => samIpa + tal
sarpatA => sarpa + tal
sahAyatA => sahAya + tal
sAraputratA => sAraputra + tal
sukumAratA => sukumAra + tal
suBagatA => suBaga + tal
suhitatA => suhita + tal
suhfdayatA => suhfdaya + tal
sUcakatA => sUcaka + tal
sUcikatA => sUcika + tal
sUtikatA => sUtika + tal
stenatA => stena + tal
sTaviratA => sTavira + tal
sTiratA => sTira + tal
svaDarmatA => svaDarma + tal
svaBAvatA => svaBAva + tal
svarAjatA => svarAja + tal
haritatA => harita + tal
hfdayatA => hfdaya + tal
hoqatA => hoqa + tal
hrasvatA => hrasva + tal
taTAtA => taTA + tal
kapitA => kapi + tal
kavitA => kavi + tal
gaRapatitA => gaRapati + tal
prajApatitA => prajApati + tal
vimatitA => vimati + tal
saMmatitA => saMmati + tal
sAkzitA => sAkzi + tal
sAraTitA => sAraTi + tal
sTAyitA => sTAyi + tal
kustrItA => kustrI + tal
duHstrItA => duHstrI + tal
aDvaryutA => aDvaryu + tal
kamaRqalutA => kamaRqalu + tal
tanutA => tanu + tal
duzWutA => duzWu + tal
pawutA => pawu + tal
bahutA => bahu + tal
mfdutA => mfdu + tal
laGutA => laGu + tal
vAyutA => vAyu + tal
suzWutA => suzWu + tal
svAdutA => svAdu + tal
pratiBUtA => pratiBU + tal
unnetftA => unnetf + tal
kartftA => kartf + tal
talzwftA => talzwf + tal
durBrAtftA => durBrAtf + tal
potftA => potf + tal
pratipasTAtftA => pratipasTAtf + tal
pratihartftA => pratihartf + tal
praSAstftA => praSAstf + tal
hartftA => hartf + tal
samrAwtA => samrAj + tal
durhfttA => durhfd + tal
niGAtitA => niGAtin + tal
bahuBAzitA => bahuBAzin + tal
saMBAzitA => saMBAzin + tal
saMvAditA => saMvAdin + tal
saMveSitA => saMveSin + tal
sabrahmacAritA => sabrahmacArin + tal
yAvAn => yat + vatup
apUpamayaH => apUpa + mayaw
darBamayaH => darBa + mayaw
pizwamayaH => pizwa + mayaw
balbajamayaH => balbaja + mayaw
yavamayaH => yava + mayaw
ratnamayaH => ratna + mayaw
vizamamayaH => vizama + mayaw
SaramayaH => Sara + mayaw
samamayaH => sama + mayaw
trimayaH => tri + mayaw
ajiravatI => ajira + matup
aDikAravAn => aDikAra + matup
avarohavAn => avaroha + matup
AyAmavAn => AyAma + matup
AsanavAn => Asana + matup
udakavAn => udaka + matup
udaravAn => udara + matup
uddAsavAn => uddAsa + matup
udBAsavAn => udBAsa + matup
udvAsavAn => udvAsa + matup
upayAmavAn => upayAma + matup
karIravAn => karIra + matup
karkavAn => karka + matup
karRavAn => karRa + matup
kAmavAn => kAma + matup
kAraRqavatI => kAraRqa + matup
kAraRqavavatI => kAraRqava + matup
kuRqavAn => kuRqa + matup
kulavAn => kula + matup
kuSavAn => kuSa + matup
kUlavAn => kUla + matup
keSavAn => keSa + matup
KaqavAn => Kaqa + matup
KadiravatI => Kadira + matup
ganDavAn => ganDa + matup
cakravAn => cakra + matup
cakravAkavatI => cakravAka + matup
CatravAn => Catra + matup
tundavAn => tunda + matup
daRqavAn => daRqa + matup
dantavAn => danta + matup
DuvakavAn => Duvaka + matup
DruvakavAn => Druvaka + matup
nizpAvavAn => nizpAva + matup
paNkavAn => paNka + matup
patravAn => patra + matup
pariRAhavAn => pariRAha + matup
parRavAn => parRa + matup
pArSvavAn => pArSva + matup
piNgavAn => piNga + matup
picaRqavAn => picaRqa + matup
pittavAn => pitta + matup
pulinavatI => pulina + matup
puzkavAn => puzka + matup
peSavAn => peSa + matup
PalavAn => Pala + matup
PenavAn => Pena + matup
balavAn => bala + matup
bisavAn => bisa + matup
bIjavAn => bIja + matup
maRqavAn => maRqa + matup
malavAn => mala + matup
mAMsavAn => mAMsa + matup
mAsavAn => mAsa + matup
yavaKadavAn => yavaKada + matup
yudDavAn => yudDa + matup
raTavAn => raTa + matup
rasavAn => rasa + matup
ruzyavAn => ruzya + matup
lalAwavAn => lalAwa + matup
vawavAn => vawa + matup
varRavAn => varRa + matup
valayavAn => valaya + matup
vAtavAn => vAta + matup
vfkzavAn => vfkza + matup
vewavAn => vewa + matup
vyAyAmavAn => vyAyAma + matup
SakalavAn => Sakala + matup
SabdavAn => Sabda + matup
SaryARavAn => SaryARa + matup
SArNavAn => SArNa + matup
SfNgavAn => SfNga + matup
SyAmavAn => SyAma + matup
siDmavAn => siDma + matup
sulavAn => sula + matup
sparSavAn => sparSa + matup
svavAn => sva + matup
haMsavatI => haMsa + matup
haMsakavatI => haMsaka + matup
azwakAvAn => azwakA + matup
karRikAvAn => karRikA + matup
kalAvAn => kalA + matup
kiSarAvAn => kiSarA + matup
kekAvAn => kekA + matup
GawAvAn => GawA + matup
cikIrzAvAn => cikIrzA + matup
jawAvAn => jawA + matup
takzaSilAvAn => takzaSilA + matup
daMzwrAvAn => daMzwrA + matup
DArAvAn => DArA + matup
patAkAvAn => patAkA + matup
picCAvAn => picCA + matup
prajYAvAn => prajYA + matup
balAkAvAn => balAkA + matup
mAlAvAn => mAlA + matup
meKalAvAn => meKalA + matup
vaqavAvAn => vaqavA + matup
SarkarAvAn => SarkarA + matup
SalAkAvAn => SalAkA + matup
SAKAvAn => SAKA + matup
SAlAvAn => SAlA + matup
saMjYAvAn => saMjYA + matup
sikatAvAn => sikatA + matup
astimAn => asti + matup
asTimAn => asTi + matup
urmimAn => urmi + matup
UrmimAn => Urmi + matup
fzivatI => fzi + matup
kfmimAn => kfmi + matup
granTimAn => granTi + matup
dalmimAn => dalmi + matup
ArjunaH => arjuna + aR
mAYjizWaH => maYjizWa + aR
AstaraRaH => AstaraRa + aR
SyAmaH => SyAma + aR
EndraH => indra + aR
nEruktaH => nirukta + aR
sEraH => sIra + aR
OtpAtaH => utpAta + aR
kOSAmbaH => kuSAmba + aR
OrRanABaH => UrRanABa + aR
mOlaH => mUla + aR
ArgayaRaH => fgayana + aR
kArzRaH => kfzRa + aR
EkahAyanam => ekahAyana + aR
SvEtaH => Sveta + aR
hEhayaH => hEhaya + aR
cOraH => cora + aR
gOkakzaH => gOkakzya + aR
ANgavidyaH => aNgavidyA + aR
mAGaH => maGA + aR
AzAQaH => AzAQA + aR
vAstuvidyaH => vAstuvidyA + aR
EqaH => iqA + aR
vEdiSaH => vidiSA + aR
pElaH => pIlA + aR
OrasaH => urasA + aR
sOBadraH => suBadrA + aR
mArtikaH => mfttikA + aR
dEvataH => devatA + aR
gOpikaH => gopikA + aR
ASvapataH => aSvapati + aR
pASupataH => paSupati + aR
rAzwrapataH => rAzwrapati + aR
SEbaH => Sibi + aR
vrEhaH => vrIhi + aR
mOnaH => muni + aR
BOmaH => BUmi + aR
smArtaH => smfti + aR
kzEtrapataH => kzetrapati + aR
AjakaroRaH => ajakaroRI + aR
kArkanDUmataH => karkanDUmatI + aR
AzAQaH => AzAQI + aR
mAGaH => mAGI + aR
ErAvataH => irAvatI + aR
sEMhikaroRaH => siMhikaroRI + aR
sOstram => sustrI + aR
pOrvaPAlgunaH => pUrvaPAlgunI + aR
bArhatam => bfhatI + aR
rEvataH => revatI + aR
cEtraH => cEtrI + aR
rORaH => roRI + aR
pOzaH => pOzI + aR
AraqavaH => araqu + aR
KARqavaH => KaRqu + aR
BAnavaH => BAnu + aR
EkzavaH => ikzu + aR
sEnDavaH => sinDu + aR
OpagavaH => upagu + aR
pOravaH => puru + aR
ArjavaH => fju + aR
mArdavaH => mfdu + aR
vERavaH => veRu + aR
kArkanDavaH => karkanDU + aR
BrAtram => BrAtf + aR
OpavastraH => upavastf + aR
sOmAtraH => sumAtf + aR
hOtraH => hotf + aR
ArjunAvaH => fjunO + aR
vARijaH => vaRij + aR
OSijaH => uSij + aR
BAgavataH => Bagavat + aR
vArivaskftaH => vArivaskft + aR
OdaSvitaH => udaSvit + aR
hEmavataH => himavat + aR
jOhvataH => juhvat + aR
pArizadaH => parizad + aR
OpanizadaH => upanizad + aR
dArzadaH => dfzad + aR
ATarvaRam => aTarvan + aR
kArmaRam => karman + aR
BAsmanaH => Basman + aR
sAmanaH => sAman + aR
jEtvanaH => jitvan + aR
yOvanam => yuvan + aR
vEmanaH => veman + aR
lOmanaH => loman + aR
SANKinaH => SaNKin + aR
gATinaH => gATin + aR
vEdaTinaH => vidaTin + aR
sOdAmanaH => sudAman + aR
kESinaH => keSin + aR
AnuzwuBaH => anuzwuB + aR
kAkuBaH => kakuB + aR
trEzwuBaH => trizwuB + aR
mAnasaH => manas + aR
vEdvasaH => vidvas + aR
OrasaH => uras + aR
EnasaH => enas + aR
OzRihaH => uzRih + aR
ASvaH => aSva + aY
kApotaH => kapota + aY
ApastambaH => Apastamba + aY
bAlam => bAla + aY
EndrAvasAnaH => indrAvasAna + aY
bEdaH => bida + aY
grEzmaH => grIzma + aY
OtsaH => utsa + aY
sOvarRaH => suvarRa + aY
SOrpaH => SUrpa + aY
ArzwizeRaH => fzwizeRa + aY
gArhaH => gfha + aY
dEvaH => deva + aY
vEyAGraH => vEyAGra + aY
lOhaH => loha + aY
prOQam => prOQa + aY
tAkzaSilaH => takzaSilA + aY
SAMSapaH => SiMSapA + aY
kzOdram => kzudrA + aY
OrRaH => UrRA + aY
pOtikaH => pUtikA + aY
pANktaH => paNkti + aY
SyAvalaH => SyAvali + aY
vEDUmAgnI => viDUmAgni + aY
jAgataH => jagatI + aY
grAmaRaH => grAmaRI + aY
pArTivaH => pfTivI + aY
EzukAvataH => EzukAvatI + aY
sEDrakAvataH => sEDrakAvatI + aY
bEndavaH => bindu + aY
AraqavaH => araqu + aY
kAkzatavaH => kakzatu + aY
dAravaH => dAru + aY
vEzRavaH => vizRu + aY
pElavaH => pIlu + aY
OpamanyavaH => upamanyu + aY
kOravaH => kuru + aY
pArTavaH => pfTu + aY
DEnavaH => Denu + aY
vADavam => vaDU + aY
pOnarBavaH => punarBU + aY
nAnAndraH => nanAndf + aY
yAtram => yAtf + aY
OdgAtram => udgAtf + aY
dOhitraH => duhitf + aY
nAram => nf + aY
pOtram => potf + aY
gAvam => go + aY
SOnakaH => Sunak + aY
mAhataH => mahat + aY
rAjaBftaH => rAjaBft + aY
EzukAvataH => izukAvat + aY
bArhataH => bfhat + aY
gOBftaH => goBft + aY
pArizadaH => parizad + aY
vEmaH => veman + aY
AnuzwupaH => anuzwup + aY
trEzwupaH => trizwup + aY
kAkuBaH => kakuB + aY
OzRihaH => uzRih + aY
AjiriH => ajira + iY
dAkziH => dakza + iY
mAziH => mAza + iY
vEgrahiH => vigraha + iY
jEviH => jIva + iY
OdumbariH => udumbara + iY
sOtaNgamiH => sutaNgama + iY
BOliNgiH => BUliNga + iY
kArzRiH => kfzRa + iY
SvEtiH => Sveta + iY
sOmadattiH => somadatta + iY
bAlAkiH => balAkA + iY
tElaKaliH => tilaKalA + iY
sOmitriH => sumitrA + iY
mOzikiH => mUzikA + iY
vArkaliH => vfkalA + iY
mArIciH => marIcI + iY
vArzaliH => vfzalI + iY
vAwAkaviH => vawAku + iY
bAhaviH => bAhu + iY
SEvAkaviH => SivAku + iY
OpabindaviH => upabindu + iY
sODAvatiH => suDAvat + iY
pOzkarasAdiH => puzkarasad + iY
AgniSarmiH => agniSarman + iY
pAYciH => paYcan + iY
vApiH => vApin + iY
EndraSarmiH => indraSarman + iY
bEjavApiH => bIjavApin + iY
OqulomiH => uquloman + iY
kOnAmiH => kunAman + iY
sOSarmiH => suSarman + iY
sOnAmiH => sunAman + iY
OrDvalomiH => UrDvaloman + iY
SArNKalatodiH => SfNKalatodin + iY
lOmiH => loman + iY
dEvaSarmiH => devaSarman + iY
SErziH => Siras + iY
ABryaH => aBra + Rya
gArgyaH => garga + Rya
AdityaH => Aditya + Rya
SAkyaH => SAka + Rya
EnyaH => ina + Rya
nEziDyaH => niziDa + Rya
tErTyaH => tIrTa + Rya
kOmByaH => kumBa + Rya
kOwyaH => kUwa + Rya
vEnyaH => vena + Rya
SAlAkyaH => SalAkA + Rya
nAsikyaH => nAsikA + Rya
ErakyaH => erakA + Rya
sEnyaH => senA + Rya
AdityaH => aditi + Rya
kAvyaH => kavi + Rya
vAtakyaH => vAtaki + Rya
dEtyaH => diti + Rya
sOparyaH => supari + Rya
vArzwyaH => vfzwi + Rya
EjyaH => eji + Rya
kESoryaH => kESori + Rya
EndralAjyaH => indralAjI + Rya
pERqyaH => piRqI + Rya
kESinyaH => keSinI + Rya
SANkavyaH => SaNku + Rya
kOravyaH => kuru + Rya
hArtryaH => hartf + Rya
vAcyaH => vAc + Rya
pEtfmatyaH => pitfmat + Rya
pArizadyaH => parizad + Rya
ASmyaH => aSman + Rya
mAdadyaH => madadin + Rya
SAkyaH => SAkin + Rya
sOpanTyaH => supanTin + Rya
rOmyaH => roman + Rya
AgniveSyaH => agniveSa + yaY
gArgyaH => garga + yaY
vAjyaH => vAja + yaY
BEzajyaH => Bizaja + yaY
dvEpyaH => dvIpa + yaY
OkTyaH => ukTa + yaY
mOdgalyaH => mudgala + yaY
DOmyaH => DUma + yaY
ArkzyaH => fkza + yaY
kArzRyaH => kfzRa + yaY
EkyaH => eka + yaY
dEvyaH => deva + yaY
gOlandyaH => golanda + yaY
sTOryaH => sTUrA + yaY
AgastyaH => agasti + yaY
kApyaH => kapi + yaY
pOlastyaH => pulasti + yaY
bArhadagnyaH => bfhadagni + yaY
mAnAyyaH => manAyI + yaY
kORqinyaH => kuRqinI + yaY
AligavyaH => aligu + yaY
mAnavyaH => manu + yaY
lEgavyaH => ligu + yaY
gOhalavyaH => guhalu + yaY
sOnavyaH => sUnu + yaY
EndrahavyaH => indrahU + yaY
pEppalavyaH => pippalU + yaY
EkalavyaH => ekalU + yaY
dEvahavyaH => devahU + yaY
BEzajyaH => Bizaj + yaY
vyAGrapAtyaH => vyAGrapAt + yaY
vEdaBftyaH => vidaBft + yaY
sOloByaH => suloBin + yaY
AnaquhyaH => anaquh + yaY
ADyAtmikaH => aDyAtma + WaY
mAhArAjikaH => mahArAja + WaY
AdityavratikaH => Adityavrata + WaY
mAsikaH => mAsa + WaY
hEraRyikaH => hiraRya + WaY
OpasargikaH => upasarga + WaY
yOvarAjikaH => yuvarAja + WaY
OrDvakAlikaH => UrDvakAla + WaY
pOrvArDikaH => pUrvArDa + WaY
EkaSatikaH => ekaSata + WaY
kEdArikam => kedAra + WaY
OdanikaH => odana + WaY
gOdAnikaH => godAna + WaY
sODAvatAnikaH => sODAvatAna + WaY
nESikaH => niSA + WaY
sAptatikaH => saptati + WaY
kASikaH => kASi + WaY
cEtikaH => ceti + WaY
BOrikikaH => BOriki + WaY
mAhAnAmnikaH => mahAnAmnI + WaY
AgrahAyaRikaH => AgrahAyaRI + WaY
gOSakawikaH => goSakawI + WaY
EkzukaH => ikzu + WaY
nEzAdakarzukaH => nizAdakarzu + WaY
vERukaH => veRu + WaY
sAktukaH => saktu + WaY
SAbarajambukaH => SabarajambU + WaY
svAsfkaH => svasf + WaY
mAtfkaH => mAtf + WaY
pEtfkaH => pitf + WaY
pOtfkaH => potf + WaY
SAratkaH => Sarad + WaY
kAvacikam => kavacin + WaY
kOnAmikaH => kunAman + WaY
ArTikaH => arTa + Wak
DArmikaH => Darma + Wak
AyurvedikaH => Ayurveda + Wak
lAkzaRikaH => lAkzaRa + Wak
EtihAsikaH => itihAsa + Wak
nEmittikaH => nimitta + Wak
grEzmikaH => grIzma + Wak
OpadeSikaH => upadeSa + Wak
kOmudikaH => kumuda + Wak
BOtikaH => BUta + Wak
mArgikaH => mfga + Wak
hEmantikaH => hemanta + Wak
lOkAyatikaH => lokAyata + Wak
AmAvAsyikaH => amAvAsyA + Wak
vArzikaH => varzA + Wak
lAkzikaH => lAkzA + Wak
vEtaRqikaH => vitaRqA + Wak
vERikaH => vIRA + Wak
SOlkaSAlikaH => SulkaSAlA + Wak
sEnikaH => senA + Wak
rOcanikaH => rocanA + Wak
AstikaH => asti + Wak
dADikaH => daDi + Wak
nAstikaH => nAsti + Wak
EzwikaH => izwi + Wak
OpavastikaH => upavasti + Wak
mOnikaH => muni + Wak
vArDuzikaH => vfdDi + Wak
ASvapAlikaH => aSvapAlI + Wak
mARipAlikaH => maRipAlI + Wak
AgrahAyaRikaH => AgrahAyaRI + Wak
dvArapAlikaH => dvArapAlI + Wak
kOkkuwikaH => kukkuwI + Wak
rEvatikaH => revatI + Wak
cEtrikaH => cEtrI + Wak
gORikaH => goRI + Wak
pASukaH => paSu + Wak
prEyaNgukaH => priyaNgu + Wak
OpajAnukaH => upajAnu + Wak
vArkabaRDukaH => vfkabanDu + Wak
DEnukam => Denu + Wak
AnusukaH => anusU + Wak
cAturhotfkaH => caturhotf + Wak
vAcikaH => vAc + Wak
ArcikaH => fc + Wak
sPEjikaH => sPij + Wak
AkasmAtkaH => akasmAt + Wak
kATaYcitkaH => kaTaYcit + Wak
OdaSvitkaH => udaSvit + Wak
kOzwacitkaH => kuzwacit + Wak
pArizatkaH => parizad + Wak
kOzWavitkaH => kuzWavid + Wak
AnugAdikaH => anugAdin + Wak
pAkzikaH => pakzin + Wak
vArkavaYcikaH => vfkavaYcin + Wak
AmBasikaH => amBas + Wak
sAhasikaH => sahas + Wak
OrasikaH => uras + Wak
OjasikaH => ojas + Wak
ASveyaH => aSva + Qak
lAkzmaReyaH => lakzmaRa + Qak
AlIQeyaH => AlIQa + Qak
BArateyaH => BArata + Qak
EtareyaH => itara + Qak
vEkAseyaH => vikAsa + Qak
jEveyaH => jIva + Qak
OgreyaH => ugra + Qak
kOSAmbeyaH => kuSAmba + Qak
kArkalAseyaH => kfkalAsa + Qak
dEvatareyaH => devatara + Qak
gOdanteyaH => godanta + Qak
AmbikeyaH => ambikA + Qak
gANgeyaH => gaNgA + Qak
SAlveyaH => SAlvA + Qak
vEnateyaH => vinatA + Qak
kOmArIkeyaH => kumArIkA + Qak
gODeyaH => goDA + Qak
kOsalyeyaH => kOsalyA + Qak
AgneyaH => agni + Qak
kApeyam => kapi + Qak
jYAteyam => jYAti + Qak
nEDeyaH => niDi + Qak
vrEheyam => vrIhi + Qak
yOvateyaH => yuvati + Qak
nAdeyaH => nadI + Qak
vArARaseyaH => vArARasI + Qak
rOkmiReyaH => rukmiRI + Qak
pOrvanagareyaH => pUrvanagarI + Qak
SyEneyaH => SyenI + Qak
rOhiReyaH => rohiRI + Qak
kOSAmbeyaH => kOSAmbI + Qak
kAmaRqaleyaH => kamaRqalu + Qak
pARqeyaH => pARqu + Qak
mArkaRqeyaH => mfkaRqu + Qak
jAmbeyaH => jambU + Qak
lEKABreyaH => leKABrU + Qak
vEmAtreyaH => vimAtf + Qak
ASmeyaH => aSman + Qak
jArateyaH => jaratin + Qak
sOnAmeyaH => sunAman + Qak
DOreyaH => Dur + Qak
dESeyaH => diS + Qak
sOvakzaseyaH => suvakzas + Qak
ASokeyaH => aSoka + QaY
sAKidatteyaH => saKidatta + QaY
pAleyaH => pAla + QaY
kzEreyaH => kzIra + QaY
pOruzeyaH => puruza + QaY
pOreyaH => pUra + QaY
kOSeyam => koSa + QaY
pAriKeyaH => pariKA + QaY
grEveyam => grIvA + QaY
AtiTeyam => atiTi + QaY
sAKeyaH => saKi + QaY
vESreyaH => viSri + QaY
OpaDeyaH => upaDi + QaY
kOdreyaH => kudri + QaY
gArzweyaH => gfzwi + QaY
vArmateyaH => varmatI + QaY
EReyaH => eRI + QaY
jAmbeyaH => jambu + QaY
SOntibAheyaH => SuntibAhu + QaY
kAmaRqaleyaH => kamaRqalU + QaY
pATeyam => paTin + QaY
CAdizeyaH => Cadiz + QaY
ASvapejI => aSvapeja + Rini
kAzAyI => kazAya + Rini
kASyapI => kASyapa + Rini
pENgI => piNga + Rini
OlapI => ulapa + Rini
pOruzAMsakI => puruzAMsaka + Rini
ArcABI => fcABa + Rini
EtareyI => Etareya + Rini
dEvadarSanI => devadarSana + Rini
kOSikI => kOSika + Rini
AlambI => Alambi + Rini
hAridravI => haridru + Rini
tOmburavI => tumburu + Rini
SElAlI => SilAlin + Rini
aNkuritaH => aNkura + itac
kaRwakitaH => kaRwaka + itac
ArAlitaH => ArAla + itac
SAstritaH => SAstra + itac
vicAritaH => vicAra + itac
sImantitaH => sImanta + itac
utkarzitaH => utkarza + itac
puzpitaH => puzpa + itac
sUcitaH => sUca + itac
fjIzitaH => fjIza + itac
SfNgAritaH => SfNgAra + itac
vegitaH => vega + itac
SEvalitaH => SEvala + itac
romAYcitaH => romAYca + itac
gOravitaH => gOrava + itac
paRqitaH => paRqA + itac
tArakitaH => tArakA + itac
pipAsitaH => pipAsA + itac
dIkzitaH => dIkzA + itac
utkaRWitaH => utkaRWA + itac
buBukzitaH => buBukzA + itac
mUrcCitaH => mUrcCA + itac
DenuzyitaH => DenuzyA + itac
vyADitaH => vyADi + itac
maYjaritaH => maYjarI + itac
kzuDitaH => kzuD + itac
varmitaH => varman + itac
tfzitaH => tfz + itac
arGyaH => arGa + yat
kaRWyaH => kaRWa + yat
AkASyaH => AkASa + yat
BAgyaH => BAga + yat
iByaH => iBa + yat
tilyaH => tila + yat
dIpyaH => dIpa + yat
udakyaH => udaka + yat
muKyaH => muKa + yat
kUpyaH => kUpa + yat
vfzyaH => vfza + yat
meGyaH => meGa + yat
ozWyaH => ozWa + yat
yogyaH => yoga + yat
agnidevatyaH => agnidevatA + yat
saByaH => saBA + yat
AmikzyaH => AmikzA + yat
SAKyaH => SAKA + yat
pitfdevatyaH => pitfdevatA + yat
sItyaH => sItA + yat
uKyaH => uKA + yat
tulyaH => tulA + yat
sTURyaH => sTURA + yat
meDyaH => meDA + yat
AdyaH => Adi + yat
vAstozpatyaH => vAstozpati + yat
jagatyam => jagatI + yat
dyAvApfTivyaH => dyAvApfTivI + yat
revatyam => revatI + yat
aRavyam => aRu + yat
maDavyaH => maDu + yat
vAyavyaH => vAyu + yat
picavyaH => picu + yat
UravyaH => Uru + yat
ftavyaH => ftu + yat
pitryaH => pitf + yat
gavyaH => go + yat
nAvyaH => nO + yat
srucyaH => sruc + yat
marutvatyaH => marutvat + yat
paTyaH => paTin + yat
sAkzyaH => sAkzin + yat
apyam => ap + yat
divyaH => div + yat
diSyaH => diS + yat
havizyaH => haviz + yat
AyuzyaH => Ayuz + yat
vayasyaH => vayas + yat
uzasyaH => uzas + yat
ojasyaH => ojas + yat
aruRatvam => aruRa + tva
maDuratvam => maDura + tva
ArADayatvam => ArADaya + tva
brAhmaRatvam => brAhmaRa + tva
idamparatvam => idampara + tva
nipuRatvam => nipuRa + tva
ISvaratvam => ISvara + tva
dIrGatvam => dIrGa + tva
uzRatvam => uzRa + tva
suKatvam => suKa + tva
mUrKatvam => mUrKa + tva
fzikatvam => fzika + tva
dfQatvam => dfQa + tva
ekatvam => eka + tva
kzetrajYatvam => kzetrajYa + tva
SoRatvam => SoRa + tva
prOQatvam => prOQa + tva
yaTAtvam => yaTA + tva
mAyAtvam => mAyA + tva
aDipatitvam => aDipati + tva
saKitvam => saKi + tva
jYAtitvam => jYAti + tva
viSastitvam => viSasti + tva
munitvam => muni + tva
fzitvam => fzi + tva
gfhapatitvam => gfhapati + tva
senApatitvam => senApati + tva
nagarItvam => nagarI + tva
strItvam => strI + tva
sustrItvam => sustrI + tva
aRutvam => aRu + tva
praButvam => praBu + tva
ASutvam => ASu + tva
sADutvam => sADu + tva
SiSutvam => SiSu + tva
urutvam => uru + tva
gurutvam => guru + tva
fjutvam => fju + tva
pfTutvam => pfTu + tva
vaDUtvam => vaDU + tva
svasftvam => svasf + tva
BrAtftvam => BrAtf + tva
pitftvam => pitf + tva
udgAtftvam => udgAtf + tva
suBrAtftvam => suBrAtf + tva
hotftvam => hotf + tva
gotvam => go + tva
vaRiktvam => vaRij + tva
ftviktvam => ftvij + tva
mahattvam => mahat + tva
yugapattvam => yugapat + tva
suhfttvam => suhfd + tva
brahmatvam => brahman + tva
rAjatvam => rAjan + tva
viGAtitvam => viGAtin + tva
SIrzaGAtitvam => SIrzaGAtin + tva
yuvatvam => yuvan + tva
meDAvitvam => meDAvin + tva
saMmanastvam => saMmanas + tva
purastvam => puras + tva
aruRatA => aruRa + tal
maDuratA => maDura + tal
ArADayatA => ArADaya + tal
brAhmaRatA => brAhmaRa + tal
idamparatA => idampara + tal
nipuRatA => nipuRa + tal
ISvaratA => ISvara + tal
dIrGatA => dIrGa + tal
uzRatA => uzRa + tal
suKatA => suKa + tal
mUrKatA => mUrKa + tal
fzikatA => fzika + tal
dfQatA => dfQa + tal
ekatA => eka + tal
kzetrajYatA => kzetrajYa + tal
SoRatA => SoRa + tal
prOQatA => prOQa + tal
yaTAtA => yaTA + tal
mAyAtA => mAyA + tal
aDipatitA => aDipati + tal
saKitA => saKi + tal
jYAtitA => jYAti + tal
viSastitA => viSasti + tal
munitA => muni + tal
fzitA => fzi + tal
gfhapatitA => gfhapati + tal
senApatitA => senApati + tal
nagarItA => nagarI + tal
strItA => strI + tal
sustrItA => sustrI + tal
aRutA => aRu + tal
praButA => praBu + tal
ASutA => ASu + tal
sADutA => sADu + tal
SiSutA => SiSu + tal
urutA => uru + tal
gurutA => guru + tal
fjutA => fju + tal
pfTutA => pfTu + tal
vaDUtA => vaDU + tal
svasftA => svasf + tal
BrAtftA => BrAtf + tal
pitftA => pitf + tal
udgAtftA => udgAtf + tal
suBrAtftA => suBrAtf + tal
hotftA => hotf + tal
gotA => go + tal
vaRiktA => vaRij + tal
ftviktA => ftvij + tal
mahattA => mahat + tal
yugapattA => yugapat + tal
suhfttA => suhfd + tal
brahmatA => brahman + tal
rAjatA => rAjan + tal
viGAtitA => viGAtin + tal
SIrzaGAtitA => SIrzaGAtin + tal
yuvatA => yuvan + tal
meDAvitA => meDAvin + tal
saMmanastA => saMmanas + tal
purastA => puras + tal
aNgavAn => aNga + matup
DanavAn => Dana + matup
ArohavAn => Aroha + matup
BAvavAn => BAva + matup
himavAn => hima + matup
SItavAn => SIta + matup
utsAhavAn => utsAha + matup
guRavAn => guRa + matup
rUpavAn => rUpa + matup
kfzRavAn => kfzRa + matup
snehavAn => sneha + matup
arcAvAn => arcA + matup
SradDAvAn => SradDA + matup
mAyAvAn => mAyA + matup
izwakAvAn => izwakA + matup
SiKAvAn => SiKA + matup
vIRAvAn => vIRA + matup
cUqAvAn => cUqA + matup
meDAvAn => meDA + matup
agnimAn => agni + matup
SaktimAn => Sakti + matup
AsutimAn => Asuti + matup
SAlimAn => SAli + matup
girimAn => giri + matup
vrIhimAn => vrIhi + matup
budDimAn => budDi + matup
palAlImAn => palAlI + matup
AsandImAn => AsandI + matup
SAkImAn => SAkI + matup
SrImAn => SrI + matup
kumArImAn => kumArI + matup
maDumAn => maDu + matup
vAyumAn => vAyu + matup
ikzumAn => ikzu + matup
mfdumAn => mfdu + matup
veRumAn => veRu + matup
parSUmAn => parSU + matup
gomAn => go + matup
nOmAn => nO + matup
vizvagvAn => vizvac + matup
sragvAn => sraj + matup
agnicitvAn => agnicit + matup
marutvAn => marut + matup
vidyutvAn => vidyut + matup
udaSvitvAn => udaSvit + matup
dfzadvAn => dfzad + matup
karmavAn => karman + matup
sAmavAn => sAman + matup
uzmavAn => uzman + matup
hemavAn => heman + matup
romavAn => roman + matup
lomavAn => loman + matup
kiv~vAn => kim + matup
yaSasvAn => yaSas + matup
BAsvAn => BAs + matup
urasvAn => uras + matup
UrjasvAn => Urjas + matup